The Dragon and the Phoenix
An Interactive Fiction by Martin Markov
Release 1 / Serial number 180909 / Inform 7 build 6M62 (I6/v6.33 lib 6/12N) SD

Park
You've been tugging at the end of your leash, but Mom's been holding you back the whole way.  Finally, you've reached the park. It is a beautiful day with neary a cloud roaming in the sky, and the park is full with people and other dogs.

Mom pulls out your favourite chewed out tennis ball, and throws it. "Go fetch the ball, Drake!". The tennis ball rolls next to a large tree.

Mom is waiting for you.

>fetch ball
"Now give me the ball, Drake!"

>get ball
You can't see any such thing.

>look
Park
You've been tugging at the end of your leash, but Mom's been holding you back  the whole way.  Finally, you've reached the park. It is a beautiful day with neary a cloud roaming in the sky, and the park is full with people and other dogs. Mom pulls out your favourite chewed out tennis ball, and throws it. "Go fetch the ball, Dragon!"

* * *

>fetch ball
"Now give me the ball, Drake!"

>take ball
"Now give me the ball, Dragon!"

>give ball to mom
Mom doesn't seem interested.

* * *

>fetch ball
"Now give me the ball, Drake!"

>give ball to mom
"Good Boy!", says Mom, and gives you a treat. You gulp it immediately and wag your tail in delight

>wait
You played in the park for hours, dashing around the people and chasing the other dogs. When Mom finally brought you home, you were so tired you were not even able to have your dinner. You just fell in your bed in the flat's corridor, and doze off.

Tavern
In your sleep, you try rolling around in your bed. It feels surprusingly hard, and you wake up startled, next to a lit fireplace. You are in a large room with several long wooden tables with benches, and a bar. A large oaken log is slowly burning in the fireplace, producing more heat than light. Shadows dance around the room, barely lighting the faces of the people here. 

A surly, bald man stands behind the bar, absent-mindedly washing a glass with an extremely dirty cloth.

A tall man wearing a long, gray cloak and eyepatch is sitting, cross-legged, next to the fire. He is carrying a long staff. Many silver hairs shimmer in his otherwise dark beard. A raven is sitting on his shoulder.

You can also see the front door here.

>look
Tavern
You are in a large room with several long wooden tables with benches, and a bar. A large oaken log is slowly burning in the fireplace, producing more heat than light. Shadows dance around the room, barely lighting the faces of the people here. 

A surly, bald man stands behind the bar, absent-mindedly washing a glass with an extremely dirty cloth.

A tall man wearing a long, gray cloak and eyepatch is sitting, cross-legged, next to the fire. He is carrying a long staff. Many silver hairs shimmer in his otherwise dark beard. A raven is sitting on his shoulder.

You can also see the front door here.

>look at stranger
You see nothing special about the stranger.

>look at barkeep
You can't see any such thing.

>look at barkeeper
You see nothing special about the tavern keeper.

* * *

The Dragon and the Phoenix
An Interactive Fiction by Martin Markov
Release 1 / Serial number 180909 / Inform 7 build 6M62 (I6/v6.33 lib 6/12N) SD

Park
You've been tugging at the end of your leash, but Mom's been holding you back the whole way.  Finally, you've reached the park. It is a beautiful day with neary a cloud roaming in the sky, and the park is full with people and other dogs.

Mom pulls out your favourite chewed out tennis ball, and throws it. "Go fetch the ball, Drake!". The tennis ball rolls next to a large tree.

Mom is waiting for you.

>look
Park
It is a beautiful day with neary a cloud roaming in the sky, and the park is full with people and other dogs.

Your favourite ball is sitting next to a large tree.

Mom is waiting for you.

>take ball
"Now give me the ball, Dragon!"

>look tree
You can't see any such thing.

>showme
Park - room
    yourself - person

* * *

>take ball
"Now give me the ball, Dragon!"

>look
Park
It is a beautiful day with neary a cloud roaming in the sky, and the park is full with people and other dogs.

You can see Mom here.

>give ball to Mom
Mom doesn't seem interested.

>look
Park
It is a beautiful day with neary a cloud roaming in the sky, and the park is full with people and other dogs.

* * *

>look
Park
It is a beautiful day with neary a cloud roaming in the sky, and the park is full with people and other dogs.

Your favourite ball is sitting next to a large tree.

Mom is waiting for you.

>fetch ball
"Now give me the ball, Drake!"

* * *

>give ball to mom
"Good Boy!", says Mom, and gives you a treat. You gulp it immediately and wag your tail in delight

>inv
You are carrying:
  a ball

* * *

>fetch ball
"Now give me the ball, Drake!"

>give ball to momo
You can't see any such thing.

>give ball to mom
"Good Boy!", says Mom, and gives you a treat. You gulp it immediately and wag your tail in delight

>talk to mom
That's not a verb I recognise.

>bark at mom
That's not a verb I recognise.

* * *

>look
Park
It is a beautiful day with neary a cloud roaming in the sky, and the park is full with people and other dogs.

Your favourite ball is sitting next to a large tree.

Mom is waiting for you.

>look at bald man
You can't see any such thing.

>look at tavern keeper
You see nothing special about the tavern keeper.

>look at stranger
You see nothing special about the stranger.

>take staff from stranger
That seems to belong to the stranger.

* * *

>look
Park
It is a beautiful day with neary a cloud roaming in the sky, and the park is full with people and other dogs.

Your favourite ball is sitting next to a large tree.

Mom is waiting for you.

>purloin claw
[Purloined.]

>take claw
The zombie is in your face, preventing you from doing that.

>z
You played in the park for hours, dashing around the people and chasing the other dogs. When Mom finally brought you home, you were so tired you were not even able to have your dinner. You just fell in your bed in the flat's corridor, and doze off.

The zombie is in your face, preventing you from doing that.

* * *

>look
Park
It is a beautiful day with neary a cloud roaming in the sky, and the park is full with people and other dogs.

Your favourite ball is sitting next to a large tree.

Mom is waiting for you.

>w
You can't go that way.

>z
You played in the park for hours, dashing around the people and chasing the other dogs. When Mom finally brought you home, you were so tired you were not even able to have your dinner. You just fell in your bed in the flat's corridor, and doze off.

Tavern
In your sleep, you try rolling around in your bed. It feels surprusingly hard, and you wake up startled, next to a lit fireplace. You are in a large room with several long wooden tables with benches, and a bar. Next to it you can see a stairway leading down. A large oaken log is slowly burning in the fireplace, producing more heat than light. Shadows dance around the room, barely lighting the faces of the people here. 

Next to the far side of the bar, on the west side of the tavern, there is a green door with a circular window, apparently leading to the garden.

A door made out of brown logs held together by metal rings is on the south wall. The coat rack and the welcome mat next to it suggest it is the front door.

A surly, bald man stands behind the bar, absent-mindedly washing a glass with an extremely dirty cloth.

A tall man wearing a long, gray cloak and eyepatch is sitting, cross-legged, next to the fire. He is carrying a long staff. Many silver hairs shimmer in his otherwise dark beard. A raven is sitting on his shoulder. He seems like a person that would be worthwile to listen to.

Above the fireplace hangs a peculiar engraving of a bird that appears to be on fire. You notice that occasionally the tall man throws a look at it and appears very thoughtful.

>purloin claw
[Purloined.]

>take claw
The claw attaches itself to one of your claws. Suddenly, it, and all your other claws, start growing, and turn from their normal white to a strange, metallic black. You feel dangerous.

>s
(first opening the front door)

Front Lawn
Outside the tavern, you see it is a large building painted white, with a red roof and a small brick chimney.
There is a large empty space on which several carts are parked.
A wide dirt road stretches in front of you. To the east a large statue towers in the middle of the village square with. To the west you can see a tall metal fence surrounding a number of graves overgrown with ivy, with a mausoleum made of white stone in the back of it.

A door made out of brown logs held together by metal rings is on the wall of the Tavern.

I beg your pardon?

>w
Graveyard Entrance
You can see a metal door here.

>purloin claw
[Purloined.]

>take claw
The claw attaches itself to one of your claws. Suddenly, it, and all your other claws, start growing, and turn from their normal white to a strange, metallic black. You feel dangerous.

*** Run-time problem P23: Attempt to look up a non-existent entry at column 1, row 4 of the table 'Table of Hints'.

* * *

The Dragon and the Phoenix
An Interactive Fiction by Martin Markov
Release 1 / Serial number 180909 / Inform 7 build 6M62 (I6/v6.33 lib 6/12N) SD

Park
You've been tugging at the end of your leash, but Mom's been holding you back the whole way.  Finally, you've reached the park. It is a beautiful day with neary a cloud roaming in the sky, and the park is full with people and other dogs.

Mom pulls out your favourite chewed out tennis ball, and throws it. "Go fetch the ball, Drake!". The tennis ball rolls next to a large tree.

Mom is waiting for you.

>get ball
"Now give me the ball, Dragon!"

>give ball to Mom
Mom doesn't seem interested.

>look
Park
It is a beautiful day with neary a cloud roaming in the sky, and the park is full with people and other dogs.

You can see Mom here.

* * *

>get ball
"Now give me the ball, Dragon!"

>give ball to mom
Mom doesn't seem interested.

* * *

The Dragon and the Phoenix
An Interactive Fiction by Martin Markov
Release 1 / Serial number 180909 / Inform 7 build 6M62 (I6/v6.33 lib 6/12N) SD

Park
You've been tugging at the end of your leash, but Mom's been holding you back the whole way.  Finally, you've reached the park. It is a beautiful day with neary a cloud roaming in the sky, and the park is full with people and other dogs.

Mom pulls out your favourite chewed out tennis ball, and throws it. "Go fetch the ball, Drake!". The tennis ball rolls next to a large tree.

Mom is waiting for you.

>fetch the ball
"Now give me the ball, Dragon!"

>give the ball to mom
Mom doesn't seem interested.

* * *

The Dragon and the Phoenix
An Interactive Fiction by Martin Markov
Release 1 / Serial number 180909 / Inform 7 build 6M62 (I6/v6.33 lib 6/12N) SD

Park
You've been tugging at the end of your leash, but Mom's been holding you back the whole way.  Finally, you've reached the park. It is a beautiful day with neary a cloud roaming in the sky, and the park is full with people and other dogs.

Mom pulls out your favourite chewed out tennis ball, and throws it. "Go fetch the ball, Drake!". The tennis ball rolls next to a large tree.

Mom is waiting for you.

>look\
That's not a verb I recognise.

>look
Park
It is a beautiful day with neary a cloud roaming in the sky, and the park is full with people and other dogs.

Your favourite ball is sitting next to a large tree.

Mom is waiting for you.

* * *

>fetch ball
"Now give me the ball, Drake!"

>give ball to Mom
"Good Boy!", says Mom, and gives you a treat. You gulp it immediately and wag your tail in delight

>inv
You are carrying nothing.

>look at Mom
You see nothing special about Mom.

>look
Park
It is a beautiful day with neary a cloud roaming in the sky, and the park is full with people and other dogs.

Mom is waiting for you.

* * *

The Dragon and the Phoenix
An Interactive Fiction by Martin Markov
Release 1 / Serial number 180909 / Inform 7 build 6M62 (I6/v6.33 lib 6/12N) SD

Park
You've been tugging at the end of your leash, but Mom's been holding you back the whole way.  Finally, you've reached the park. It is a beautiful day with neary a cloud roaming in the sky, and the park is full with people and other dogs.

Mom pulls out your favourite chewed out tennis ball, and throws it. "Go fetch the ball, Drake!". The tennis ball rolls next to a large tree.

Mom is waiting for you.

>open front door
You open the front door.

>s
front lawn
You can see the front door here.

>look
front lawn
You can see the front door here.

* * *

The Dragon and the Phoenix
An Interactive Fiction by Martin Markov
Release 1 / Serial number 180909 / Inform 7 build 6M62 (I6/v6.33 lib 6/12N) SD

Park
You've been tugging at the end of your leash, but Mom's been holding you back the whole way.  Finally, you've reached the park. It is a beautiful day with neary a cloud roaming in the sky, and the park is full with people and other dogs.

Mom pulls out your favourite chewed out tennis ball, and throws it. "Go fetch the ball, Drake!". The tennis ball rolls next to a large tree.

Mom is waiting for you.

>wait
You played in the park for hours, dashing around the people and chasing the other dogs. When Mom finally brought you home, you were so tired you were not even able to have your dinner. You just fell in your bed in the flat's corridor, and doze off.

Tavern
In your sleep, you try rolling around in your bed. It feels surprusingly hard, and you wake up startled, next to a lit fireplace. You are in a large room with several long wooden tables with benches, and a bar. A large oaken log is slowly burning in the fireplace, producing more heat than light. Shadows dance around the room, barely lighting the faces of the people here. 

Next to the far side of the bar, on the west side of the tavern, there is a green door with a circular window, apparently leading to the garden.

A door made out of brown logs held together by metal rings is on the south wall. The coat rack and the welcome mat next to it suggest it is the front door.

A surly, bald man stands behind the bar, absent-mindedly washing a glass with an extremely dirty cloth.

A tall man wearing a long, gray cloak and eyepatch is sitting, cross-legged, next to the fire. He is carrying a long staff. Many silver hairs shimmer in his otherwise dark beard. A raven is sitting on his shoulder.

>play
That's not a verb I recognise.

>examine barkeep
You can't see any such thing.

>examine barkeeper
You see nothing special about the tavern keeper.

>examine tall man
You see nothing special about the stranger.

>wave at tall man
You can't see any such thing.

>wave tall man
But you aren't holding him.

>wave hands at tall man
You can't see any such thing.

>wave hands tall man
You can't see any such thing.

>wave hands strange
You can't see any such thing.

>wave stranger
But you aren't holding him.

>wave hands
You can't see any such thing.

>wave
You wave.

>x me
As good-looking as ever.

* * *

>s
(first opening the front door)

front lawn
A door made out of brown logs held together by metal rings is on the south wall. The coat rack and the welcome mat next to it suggest it is the front door.

>time
That's not a verb I recognise.

* * *

>look at barkeep
You see nothing special about the tavern keeper.

>look at tall man
You see nothing special about the stranger.

>look at front door
You see nothing special about the front door.

>open front door
You open the front door.

>s
front lawn
Outside the tavern, you see it is a large building painted white, with a red roof and a small brick chimney.
There is a large empty space on which several carts are parked.
A wide dirt road stretches in front of you. To the east a large statue towers in the middle of the village square with. To the west you can see a tall metal fence surrounding a number of graves overgrown with ivy, with a mausoleum made of white stone in the back of it.

A door made out of brown logs held together by metal rings is on the south wall. The coat rack and the welcome mat next to it suggest it is the front door.

* * *

>go to garden
You can't see any such thing.

>open green door
You open the green door.

>open green door
That's already open.

>west
Garden
A number of sickly-looking vegetables grow around in the garden of the tarven. A huge rose bush grows next to the wall of the tavern. A dinky door blocks a trail into the hill behind the tavern.

Next to the far side of the bar, on the west side of the tavern, there is a green door with a circular window, apparently leading to the garden.

You can also see a dinky door here.

>east
Tavern
You are in a large room with several long wooden tables with benches, and a bar. A large oaken log is slowly burning in the fireplace, producing more heat than light. Shadows dance around the room, barely lighting the faces of the people here. 

Next to the far side of the bar, on the west side of the tavern, there is a green door with a circular window, apparently leading to the garden.

A door made out of brown logs held together by metal rings is on the south wall. The coat rack and the welcome mat next to it suggest it is the front door.

A surly, bald man stands behind the bar, absent-mindedly washing a glass with an extremely dirty cloth.

A tall man wearing a long, gray cloak and eyepatch is sitting, cross-legged, next to the fire. He is carrying a long staff. Many silver hairs shimmer in his otherwise dark beard. A raven is sitting on his shoulder.

>south
(first opening the front door)

front lawn
Outside the tavern, you see it is a large building painted white, with a red roof and a small brick chimney.
There is a large empty space on which several carts are parked.
A wide dirt road stretches in front of you. To the east a large statue towers in the middle of the village square with. To the west you can see a tall metal fence surrounding a number of graves overgrown with ivy, with a mausoleum made of white stone in the back of it.

A door made out of brown logs held together by metal rings is on the south wall.

* * *

>south
(first opening the front door)

front lawn
Outside the tavern, you see it is a large building painted white, with a red roof and a small brick chimney.
There is a large empty space on which several carts are parked.
A wide dirt road stretches in front of you. To the east a large statue towers in the middle of the village square with. To the west you can see a tall metal fence surrounding a number of graves overgrown with ivy, with a mausoleum made of white stone in the back of it.

A door made out of brown logs held together by metal rings is on the wall of the Tavern.

>north
Tavern
You are in a large room with several long wooden tables with benches, and a bar. A large oaken log is slowly burning in the fireplace, producing more heat than light. Shadows dance around the room, barely lighting the faces of the people here. 

A door made out of brown logs held together by metal rings is on the south wall. The coat rack and the welcome mat next to it suggest it is the front door.

Next to the far side of the bar, on the west side of the tavern, there is a green door with a circular window, apparently leading to the garden.

A surly, bald man stands behind the bar, absent-mindedly washing a glass with an extremely dirty cloth.

A tall man wearing a long, gray cloak and eyepatch is sitting, cross-legged, next to the fire. He is carrying a long staff. Many silver hairs shimmer in his otherwise dark beard. A raven is sitting on his shoulder.

>west
(first opening the green door)

Garden
A number of sickly-looking vegetables grow around in the garden of the tarven. A huge rose bush grows next to the wall of the tavern. A dinky door blocks a trail into the hill behind the tavern.

Through the green door's window you can see the tavern keeper still "cleaning" the same glass.

>open dinky door
You open the dinky door.

>north
Hill
You stand amid the golden wheat at the top of the hill. You can see the tavern's red roof, and the door to its garden. To the north, you can see a trail leading off into the mountains. To the west you see a forest in the distance.

>west
forest entrance

>east
Hill
You stand amid the golden wheat at the top of the hill. You can see the tavern's red roof, and the door to its garden. To the north, you can see a trail leading off into the mountains. To the west you see a forest in the distance.

>north
mountain trail

>south
Hill
You stand amid the golden wheat at the top of the hill. You can see the tavern's red roof, and the door to its garden. To the north, you can see a trail leading off into the mountains. To the west you see a forest in the distance.

>south
Garden
A number of sickly-looking vegetables grow around in the garden of the tarven. A huge rose bush grows next to the wall of the tavern. A dinky door blocks a trail into the hill behind the tavern.

Through the green door's window you can see the tavern keeper still "cleaning" the same glass.

>east
Tavern
You are in a large room with several long wooden tables with benches, and a bar. A large oaken log is slowly burning in the fireplace, producing more heat than light. Shadows dance around the room, barely lighting the faces of the people here. 

Next to the far side of the bar, on the west side of the tavern, there is a green door with a circular window, apparently leading to the garden.

A door made out of brown logs held together by metal rings is on the south wall. The coat rack and the welcome mat next to it suggest it is the front door.

A surly, bald man stands behind the bar, absent-mindedly washing a glass with an extremely dirty cloth.

A tall man wearing a long, gray cloak and eyepatch is sitting, cross-legged, next to the fire. He is carrying a long staff. Many silver hairs shimmer in his otherwise dark beard. A raven is sitting on his shoulder.

>south
front lawn
Outside the tavern, you see it is a large building painted white, with a red roof and a small brick chimney.
There is a large empty space on which several carts are parked.
A wide dirt road stretches in front of you. To the east a large statue towers in the middle of the village square with. To the west you can see a tall metal fence surrounding a number of graves overgrown with ivy, with a mausoleum made of white stone in the back of it.

A door made out of brown logs held together by metal rings is on the wall of the Tavern.

>west
graveyard entrance
You can see a metal door here.

>open metal door
It seems to be locked.

* * *

The Dragon and the Phoenix
An Interactive Fiction by Martin Markov
Release 1 / Serial number 180909 / Inform 7 build 6M62 (I6/v6.33 lib 6/12N) SD

Park
You've been tugging at the end of your leash, but Mom's been holding you back the whole way.  Finally, you've reached the park. It is a beautiful day with neary a cloud roaming in the sky, and the park is full with people and other dogs.

Mom pulls out your favourite chewed out tennis ball, and throws it. "Go fetch the ball, Drake!". The tennis ball rolls next to a large tree.

Mom is waiting for you.

>x me
Your coat is black, soft and shiny. Your paws are soft, smooth and agile. Your claws are white and neat, since Mom insists on cutting them for you.

>wait
You played in the park for hours, dashing around the people and chasing the other dogs. When Mom finally brought you home, you were so tired you were not even able to have your dinner. You just fell in your bed in the flat's corridor, and doze off.

Tavern
In your sleep, you try rolling around in your bed. It feels surprusingly hard, and you wake up startled, next to a lit fireplace. You are in a large room with several long wooden tables with benches, and a bar. A large oaken log is slowly burning in the fireplace, producing more heat than light. Shadows dance around the room, barely lighting the faces of the people here. 

Next to the far side of the bar, on the west side of the tavern, there is a green door with a circular window, apparently leading to the garden.

A door made out of brown logs held together by metal rings is on the south wall. The coat rack and the welcome mat next to it suggest it is the front door.

A surly, bald man stands behind the bar, absent-mindedly washing a glass with an extremely dirty cloth.

A tall man wearing a long, gray cloak and eyepatch is sitting, cross-legged, next to the fire. He is carrying a long staff. Many silver hairs shimmer in his otherwise dark beard. A raven is sitting on his shoulder.

Above the fireplace hangs a peculiar engraving of a bird that appears to be on fire. You notice that occasionally the tall man throws a look at it and appears very thoughtful.

You can also see a claw, heart, ash and wing here.

>look
Tavern
You are in a large room with several long wooden tables with benches, and a bar. A large oaken log is slowly burning in the fireplace, producing more heat than light. Shadows dance around the room, barely lighting the faces of the people here. 

Next to the far side of the bar, on the west side of the tavern, there is a green door with a circular window, apparently leading to the garden.

A door made out of brown logs held together by metal rings is on the south wall. The coat rack and the welcome mat next to it suggest it is the front door.

A surly, bald man stands behind the bar, absent-mindedly washing a glass with an extremely dirty cloth.

A tall man wearing a long, gray cloak and eyepatch is sitting, cross-legged, next to the fire. He is carrying a long staff. Many silver hairs shimmer in his otherwise dark beard. A raven is sitting on his shoulder.

Above the fireplace hangs a peculiar engraving of a bird that appears to be on fire. You notice that occasionally the tall man throws a look at it and appears very thoughtful.

You can also see a claw, heart, ash and wing here.

>take wing
The wing is suddenly picked up by a gust of wind. It floats in the air, until landing softly on your back. You feel it splitting in two, and attaching the halves behind your shoulder plates. The process is not painful, takes only a couple of minutes, and then you feel lighter.

>x me
A pair of leathery wings sprout from your back. Your paws are soft, smooth and agile. Your claws are white and neat, since Mom insists on cutting them for you.

>touch engraving
You spread your wings and smoothly glide to the engraving as soon as you touch it, it gains colour in a flurry of sparks. Its wings start glowing.

>take claw
The claw attaches itself to one of your claws. Suddenly, it, and all your other claws, start growing, and turn from white to a strange, metallic black. You feel dangerous.

>touch engraving
You spread your wings and smoothly glide to the engraving as soon as you touch it, it gains colour in a flurry of sparks. Its clawes, and wings start glowing.

>take heart
The heart rises in the air, starts glowing, and turns into a ray of light that shoots straight at your heart. You feel a warm light spreading inside you. Your mind expands to new understanding and you feel you can now talk to people.

>take ash
You try picking the ash in your mouth, but swallow it accidentally. Your intestines feel like they're on fire, and you wonder if your muzzle will fall off from the pain. Eventually the pain subsides. The fire, on the other hand, doesn't...

>touch engraving
You spread your wings and smoothly glide to the engraving as soon as you touch it, it gains colour in a flurry of sparks. Its flames, eyes, clawes, and wings start glowing.
The bird on the engraving seems to come to live as it radiates sunlight. Suddenly, with a bright flash, it turns into a small, crimson egg.
Touching the egg seems to make the entire world spin.

Home
You wake up in your own bed.

>w
You can't go that way.

>z
You played in the park for hours, dashing around the people and chasing the other dogs. When Mom finally brought you home, you were so tired you were not even able to have your dinner. You just fell in your bed in the flat's corridor, and doze off.

Tavern
You are in a large room with several long wooden tables with benches, and a bar. A large oaken log is slowly burning in the fireplace, producing more heat than light. Shadows dance around the room, barely lighting the faces of the people here. 

Next to the far side of the bar, on the west side of the tavern, there is a green door with a circular window, apparently leading to the garden.

A door made out of brown logs held together by metal rings is on the south wall. The coat rack and the welcome mat next to it suggest it is the front door.

A surly, bald man stands behind the bar, absent-mindedly washing a glass with an extremely dirty cloth.

A tall man wearing a long, gray cloak and eyepatch is sitting, cross-legged, next to the fire. He is carrying a long staff. Many silver hairs shimmer in his otherwise dark beard. A raven is sitting on his shoulder.

Above the fireplace hangs a peculiar engraving of a bird that appears to be on fire. You notice that occasionally the tall man throws a look at it and appears very thoughtful.

>touch engraving
You spread your wings and smoothly glide to the engraving as soon as you touch it, it gains colour in a flurry of sparks. Its flames, eyes, clawes, and wings start glowing.
The bird on the engraving seems to come to live as it radiates sunlight. Suddenly, with a bright flash, it turns into a small, crimson egg.
Touching the egg seems to make the entire world spin.

Home
You wake up in your own bed.

* * *

The Dragon and the Phoenix
An Interactive Fiction by Martin Markov
Release 1 / Serial number 180909 / Inform 7 build 6M62 (I6/v6.33 lib 6/12N) SD

Park
You've been tugging at the end of your leash, but Mom's been holding you back the whole way.  Finally, you've reached the park. It is a beautiful day with neary a cloud roaming in the sky, and the park is full with people and other dogs.

Mom pulls out your favourite chewed out tennis ball, and throws it. "Go fetch the ball, Drake!". The tennis ball rolls next to a large tree.

Mom is waiting for you.

>z
You played in the park for hours, dashing around the people and chasing the other dogs. When Mom finally brought you home, you were so tired you were not even able to have your dinner. You just fell in your bed in the flat's corridor, and doze off.

Tavern
In your sleep, you try rolling around in your bed. It feels surprusingly hard, and you wake up startled, next to a lit fireplace. You are in a large room with several long wooden tables with benches, and a bar. Next to it you can see a stairway leading down. A large oaken log is slowly burning in the fireplace, producing more heat than light. Shadows dance around the room, barely lighting the faces of the people here. 

Next to the far side of the bar, on the west side of the tavern, there is a green door with a circular window, apparently leading to the garden.

A door made out of brown logs held together by metal rings is on the south wall. The coat rack and the welcome mat next to it suggest it is the front door.

A surly, bald man stands behind the bar, absent-mindedly washing a glass with an extremely dirty cloth.

A tall man wearing a long, gray cloak and eyepatch is sitting, cross-legged, next to the fire. He is carrying a long staff. Many silver hairs shimmer in his otherwise dark beard. A raven is sitting on his shoulder. He seems like a person that would be worthwile to listen to.

Above the fireplace hangs a peculiar engraving of a bird that appears to be on fire. You notice that occasionally the tall man throws a look at it and appears very thoughtful.

>take claw
You can't see any such thing.

>touch engraving
You can hardly reach the engraving from the ground.

>take wing
The wing is suddenly picked up by a gust of wind. It floats in the air, until landing softly on your back. You feel it splitting in two, and attaching the halves behind your shoulder plates. The process is not painful, takes only a couple of minutes, and then you feel lighter.

>take heart
The heart rises in the air, starts glowing, and turns into a ray of light that shoots straight at your heart. You feel a warm light spreading inside you. Your mind expands to new understanding and you feel you can now talk to people.

>take ash
You try carefully picking the ash in your maw, but swallow it accidentally. Your intestines feel like they're on fire, and you wonder if your muzzle will fall off from the pain. Eventually the pain subsides. The fire, on the other hand, doesn't...

>touch engraving
You spread your wings and smoothly glide to the engraving as soon as you touch it, it gains colour in a flurry of sparks. Its flames, eyes, clawes, and wings start glowing.
The bird on the engraving seems to come to live as it radiates sunlight. Suddenly, with a bright flash, it turns into a small, crimson egg.
Touching the egg seems to make the entire world spin.

    *** You wake up in your own bed. Once more, your coat is black and shiny, instead of made of scales, you have no wings on your back, and the fire inside your lungs seems to have quelled. Curiously though, under your paws you feel a warm, oval object. ***

Would you like to RESTART, RESTORE a saved game, QUIT or UNDO the last command?

* * *

>take claw
You can't see any such thing.

>purloin claw
[Purloined.]

>take claw
The claw attaches itself to one of your claws. Suddenly, it, and all your other claws, start growing, and turn from white to a strange, metallic black. You feel dangerous.

>attack barkeep
Violence isn't the answer to this one.

* * *

>z
Time passes.

>s
(first opening the front door)

Front Lawn
Outside the tavern, you see it is a large building painted white, with a red roof and a small brick chimney.
There is a large empty space on which several carts are parked.
A wide dirt road stretches in front of you. To the east a large statue towers in the middle of the village square with. To the west you can see a tall metal fence surrounding a number of graves overgrown with ivy, with a mausoleum made of white stone in the back of it.

A door made out of brown logs held together by metal rings is on the wall of the Tavern.

>e
Village Square

>purloin claw
[Purloined.]

>inv
You are carrying:
  a claw

>drop claw
Dropped.

>take claw
The claw attaches itself to one of your claws. Suddenly, it, and all your other claws, start growing, and turn from white to a strange, metallic black. You feel dangerous.

>take heart
You can't see any such thing.

>purloin heart
[Purloined.]

>take heart
The heart rises in the air, starts glowing, and turns into a ray of light that shoots straight at your heart. You feel a warm light spreading inside you. Your mind expands to new understanding and you feel you can now talk to people.

>purloin wing
[Purloined.]

>take wing
The wing is suddenly picked up by a gust of wind. It floats in the air, until landing softly on your back. You feel it splitting in two, and attaching the halves behind your shoulder plates. The process is not painful, takes only a couple of minutes, and then you feel lighter.

>q
Are you sure you want to quit?

* * *

>z
Time passes.

>w
(first opening the green door)

Garden
A number of sickly-looking vegetables grow around the garden of the tavern. A huge rosebush grows next to the wall of the tavern. A dinky door blocks a trail into the hill behind the tavern.

Through the green door's window you can see the tavern keeper still "cleaning" the same glass.

On the rosebush several roses are scattered like blotches of blood red paint.

>n
(first opening the dinky door)

Hill
You stand amid the golden wheat at the top of the hill. You can see the tavern's red roof, and the door to its garden. To the north, you can see a trail leading off into the mountains. To the west you see a forest in the distance.

>w
Forest Entrance
As you proceed west, you enter a forest of tall beech trees. At first walking around seems easy, but you can see that the trees get thicker, and there are more and more bushes in the way.
There are two paths leading deeper into the forest. The trail to the west appears to be sloping down quite steeply. There's a sign next to it saying "DANGER! WASPS! There is another trail to the north. It appears that the trees are particularly trick that way.

>w
Wasp Hive
As you continue down the trail, you hear a faint buzzing, which gradually gets louder. Suddenly, three wasps surround you. You don't think you'll be able to proceed.

>attack wasp
You can hardly do anything to the wasp like that.

>purloin claw
[Purloined.]

* * *

>take claw
The claw attaches itself to one of your claws. Suddenly, it, and all your other claws, start growing, and turn from their normal white to a strange, metallic black. You feel dangerous.

>attack wasp
You claw the wasp into a thousand pieces.
The wasp's carapace falls next to its lifeless body.

>look
Wasp Hive
As you continue down the trail, you hear a faint buzzing, which gradually gets louder. Suddenly, two wasps surround you. You don't think you'll be able to proceed.

You can see a carapace here.

>look
Wasp Hive
As you continue down the trail, you hear a faint buzzing, which gradually gets louder. Suddenly, two wasps surround you. You don't think you'll be able to proceed.

You can see a carapace here.

>attack wasp
You claw the wasp into a thousand pieces.
The wasp's carapace falls next to its lifeless body.

>attack wasp
You claw the wasp into a thousand pieces.
The wasp's carapace falls next to its lifeless body.

>look
Wasp Hive
As you continue down the trail,  you enjoy some peace and quiet. Down, beneath the trees, you can see the sparkling blue of lake water.

You can see three carapaces here.

>take carapaces
carapace: Taken.
carapace: Taken.
carapace: Taken.

>x carapaces
You can't use multiple objects with that verb.

>x carapace
You see nothing special about the carapace.

>s
You can't go that way.

>z
Time passes.

>w
Forest Lake
You come accross a huge lake in the middle of the forest. To the west, in the lake's center, is an island, dominated by an oak so huge that its branches are reaching over the water. Lillies are scattered accross the lake's surface. A bunch of other flowers are littered on its banks.

>e
Wasp Hive
As you continue down the trail,  you enjoy some peace and quiet. Down, beneath the trees, you can see the sparkling blue of lake water.

>e
Forest Entrance
As you proceed west, you enter a forest of tall beech trees. At first walking around seems easy, but you can see that the trees get thicker, and there are more and more bushes in the way.
There are two paths leading deeper into the forest. The trail to the west appears to be sloping down quite steeply. There's a sign next to it saying "DANGER! WASPS! There is another trail to the north. It appears that the trees are particularly trick that way.

>e
Hill
You stand amid the golden wheat at the top of the hill. You can see the tavern's red roof, and the door to its garden. To the north, you can see a trail leading off into the mountains. To the west you see a forest in the distance.

>s
Garden
A number of sickly-looking vegetables grow around the garden of the tavern. A huge rosebush grows next to the wall of the tavern. A dinky door blocks a trail into the hill behind the tavern.

Through the green door's window you can see the tavern keeper still "cleaning" the same glass.

On the rosebush several roses are scattered like blotches of blood red paint.

>e
Tavern
You are in a large room with several long wooden tables with benches, and a bar. Next to it you can see a stairway leading down. A large oaken log is slowly burning in the fireplace, producing more heat than light. Shadows dance around the room, barely lighting the faces of the people here. 

Next to the far side of the bar, on the west side of the tavern, there is a green door with a circular window, apparently leading to the garden.

A door made out of brown logs held together by metal rings is on the south wall. The coat rack and the welcome mat next to it suggest it is the front door.

A surly, bald man stands behind the bar, absent-mindedly washing a glass with an extremely dirty cloth.

A tall man wearing a long, gray cloak and eyepatch is sitting, cross-legged, next to the fire. He is carrying a long staff. Many silver hairs shimmer in his otherwise dark beard. A raven is sitting on his shoulder. He seems like a person that would be worthwile to listen to.

Above the fireplace hangs a peculiar engraving of a bird that appears to be on fire. You notice that occasionally the tall man throws a look at it and appears very thoughtful.

>n
You can't go that way.

>s
(first opening the front door)

Front Lawn
Outside the tavern, you see it is a large building painted white, with a red roof and a small brick chimney.
There is a large empty space on which several carts are parked.
A wide dirt road stretches in front of you. To the east a large statue towers in the middle of the village square with. To the west you can see a tall metal fence surrounding a number of graves overgrown with ivy, with a mausoleum made of white stone in the back of it.

A door made out of brown logs held together by metal rings is on the wall of the Tavern.

>w
Graveyard Entrance
You can see a metal door here.

>w
You can't go that way.

>s
(first opening the metal door)
It seems to be locked.

>e
Front Lawn
Outside the tavern, you see it is a large building painted white, with a red roof and a small brick chimney.
There is a large empty space on which several carts are parked.
A wide dirt road stretches in front of you. To the east a large statue towers in the middle of the village square with. To the west you can see a tall metal fence surrounding a number of graves overgrown with ivy, with a mausoleum made of white stone in the back of it.

A door made out of brown logs held together by metal rings is on the wall of the Tavern.

>n
Tavern
You are in a large room with several long wooden tables with benches, and a bar. Next to it you can see a stairway leading down. A large oaken log is slowly burning in the fireplace, producing more heat than light. Shadows dance around the room, barely lighting the faces of the people here. 

A door made out of brown logs held together by metal rings is on the south wall. The coat rack and the welcome mat next to it suggest it is the front door.

Next to the far side of the bar, on the west side of the tavern, there is a green door with a circular window, apparently leading to the garden.

A surly, bald man stands behind the bar, absent-mindedly washing a glass with an extremely dirty cloth.

A tall man wearing a long, gray cloak and eyepatch is sitting, cross-legged, next to the fire. He is carrying a long staff. Many silver hairs shimmer in his otherwise dark beard. A raven is sitting on his shoulder. He seems like a person that would be worthwile to listen to.

Above the fireplace hangs a peculiar engraving of a bird that appears to be on fire. You notice that occasionally the tall man throws a look at it and appears very thoughtful.

>down
You manage to sneak by the tavern keeper and go downstairs.

Basement
Jars, bottles, crates and boxes of all kinds are scattered around the basement.

A hunk of yellow cheese is sitting on one of the boxes.

Something is shimmering on a crate in the furthest corner. On closer inspection it seems to be an iron key with a round end.

>take key
Taken.

>take chees
You can't see any such thing.

>take cheese
Taken.

>up
Tavern
You are in a large room with several long wooden tables with benches, and a bar. Next to it you can see a stairway leading down. A large oaken log is slowly burning in the fireplace, producing more heat than light. Shadows dance around the room, barely lighting the faces of the people here. 

A door made out of brown logs held together by metal rings is on the south wall. The coat rack and the welcome mat next to it suggest it is the front door.

Next to the far side of the bar, on the west side of the tavern, there is a green door with a circular window, apparently leading to the garden.

A surly, bald man stands behind the bar, absent-mindedly washing a glass with an extremely dirty cloth.

A tall man wearing a long, gray cloak and eyepatch is sitting, cross-legged, next to the fire. He is carrying a long staff. Many silver hairs shimmer in his otherwise dark beard. A raven is sitting on his shoulder. He seems like a person that would be worthwile to listen to.

Above the fireplace hangs a peculiar engraving of a bird that appears to be on fire. You notice that occasionally the tall man throws a look at it and appears very thoughtful.

>s
Front Lawn
Outside the tavern, you see it is a large building painted white, with a red roof and a small brick chimney.
There is a large empty space on which several carts are parked.
A wide dirt road stretches in front of you. To the east a large statue towers in the middle of the village square with. To the west you can see a tall metal fence surrounding a number of graves overgrown with ivy, with a mausoleum made of white stone in the back of it.

A door made out of brown logs held together by metal rings is on the wall of the Tavern.

>w
Graveyard Entrance
You can see a metal door here.

>s
(first opening the metal door)
It seems to be locked.

>unlock door with iron key
That doesn't seem to fit the lock.

>unlock door with roundiron key
You can't see any such thing.

>unlock door with round iron key
That doesn't seem to fit the lock.

>unlock metal door with round iron key
That doesn't seem to fit the lock.

>inv
You are carrying:
  a cheese
  a round iron key
  three carapaces

* * *

>attack barkeep
Violence isn't the answer to this one.

>attack bird
You can hardly do anything to the bird of prey like that.

* * *

>attack bird
You stand your ground against the bird. It flies away, cawing loudly.

>look
Tavern
You are in a large room with several long wooden tables with benches, and a bar. A large oaken log is slowly burning in the fireplace, producing more heat than light. Shadows dance around the room, barely lighting the faces of the people here. 

Next to the far side of the bar, on the west side of the tavern, there is a green door with a circular window, apparently leading to the garden.

A door made out of brown logs held together by metal rings is on the south wall. The coat rack and the welcome mat next to it suggest it is the front door.

A surly, bald man stands behind the bar, absent-mindedly washing a glass with an extremely dirty cloth.

A tall man wearing a long, gray cloak and eyepatch is sitting, cross-legged, next to the fire. He is carrying a long staff. Many silver hairs shimmer in his otherwise dark beard. A raven is sitting on his shoulder.

Above the fireplace hangs a peculiar engraving of a bird that appears to be on fire. You notice that occasionally the tall man throws a look at it and appears very thoughtful.

>UNDO
Tavern
[Previous turn undone.]

>UNDO
Tavern
[Previous turn undone.]

>look\
That's not a verb I recognise.

>look
Tavern
You are in a large room with several long wooden tables with benches, and a bar. A large oaken log is slowly burning in the fireplace, producing more heat than light. Shadows dance around the room, barely lighting the faces of the people here. 

Next to the far side of the bar, on the west side of the tavern, there is a green door with a circular window, apparently leading to the garden.

A door made out of brown logs held together by metal rings is on the south wall. The coat rack and the welcome mat next to it suggest it is the front door.

A surly, bald man stands behind the bar, absent-mindedly washing a glass with an extremely dirty cloth.

A tall man wearing a long, gray cloak and eyepatch is sitting, cross-legged, next to the fire. He is carrying a long staff. Many silver hairs shimmer in his otherwise dark beard. A raven is sitting on his shoulder.

Above the fireplace hangs a peculiar engraving of a bird that appears to be on fire. You notice that occasionally the tall man throws a look at it and appears very thoughtful.

You can also see a bird of prey here.

>purloin claw
[Purloined.]

* * *

>take claw
The claw attaches itself to one of your claws. Suddenly, it, and all your other claws, start growing, and turn from their normal white to a strange, metallic black. You feel dangerous.

>attack bird
You claw the bird of prey into a thousand pieces.

* * *

>e
You can't go that way.

>w
(first opening the green door)

Garden
A number of sickly-looking vegetables grow around the garden of the tavern. A huge rosebush grows next to the wall of the tavern. A dinky door blocks a trail into the hill behind the tavern.

Through the green door's window you can see the tavern keeper still "cleaning" the same glass.

On the rosebush are ten Several roses are scattered like blotches of blood red paint through the bush.
.

>open dinky door
You open the dinky door.

>n
Hill
You stand amid the golden wheat at the top of the hill. You can see the tavern's red roof, and the door to its garden. To the north, you can see a trail leading off into the mountains. To the west you see a forest in the distance.

>w
Forest Entrance
As you proceed west, you enter a forest of tall beech trees. At first walking around seems easy, but you can see that the trees get thicker, and there are more and more bushes in the way.
There are two paths leading deeper into the forest. The trail to the west appears to be sloping down quite steeply. There's a sign next to it saying "DANGER! WASPS! There is another trail to the south. It appears that the trees are particularly trick that way.

>w
Wasp Hive
As you continue down the trail, you hear a faint buzzing, which gradually gets louder. Suddenly, three wasps surround you. You don't think you'll be able to proceed. Down, beneath the trees, you can see the sparkling blue of lake water.

You can see three wasps here.

>attack wasp
Violence isn't the answer to this one.

* * *

>w
(first opening the green door)

Garden
A number of sickly-looking vegetables grow around the garden of the tavern. A huge rosebush grows next to the wall of the tavern. A dinky door blocks a trail into the hill behind the tavern.

Through the green door's window you can see the tavern keeper still "cleaning" the same glass.

On the rosebush several roses are scattered like blotches of blood red paint.

* * *

>take claw
The claw attaches itself to one of your claws. Suddenly, it, and all your other claws, start growing, and turn from their normal white to a strange, metallic black. You feel dangerous.

>attack wasp
You claw the wasp into a thousand pieces.

>look
Wasp Hive
As you continue down the trail, you hear a faint buzzing, which gradually gets louder. Suddenly, two wasps surround you. You don't think you'll be able to proceed.

>attack wasp
You claw the wasp into a thousand pieces.

>look
Wasp Hive
As you continue down the trail, you hear a faint buzzing, which gradually gets louder. Suddenly, one wasp surround you. You don't think you'll be able to proceed. Down, beneath the trees, you can see the sparkling blue of lake water.

You can see a wasp here.

>attack wasp
You claw the wasp into a thousand pieces.

>look
Wasp Hive
As you continue down the trail,  you enjoy some peace and quiet. Down, beneath the trees, you can see the sparkling blue of lake water.

>n
You can't go that way.

>w
You can't go that way.

>e
Forest Entrance
As you proceed west, you enter a forest of tall beech trees. At first walking around seems easy, but you can see that the trees get thicker, and there are more and more bushes in the way.
There are two paths leading deeper into the forest. The trail to the west appears to be sloping down quite steeply. There's a sign next to it saying "DANGER! WASPS! There is another trail to the south. It appears that the trees are particularly trick that way.

>w
Wasp Hive
As you continue down the trail,  you enjoy some peace and quiet. Down, beneath the trees, you can see the sparkling blue of lake water.

* * *

>look
Wasp Hive
As you continue down the trail, you hear a faint buzzing, which gradually gets louder. Suddenly, two wasps surround you. You don't think you'll be able to proceed.

>purloin carapace
There seems to be no such object anywhere in the model world.

* * *

>look
Wasp Hive
As you continue down the trail, you hear a faint buzzing, which gradually gets louder. Suddenly, two wasps surround you. You don't think you'll be able to proceed.

>take carapace
You can't see any such thing.

* * *

>attack wasp
You claw the wasp into a thousand pieces.

>purloin wasp wing
There seems to be no such object anywhere in the model world.

* * *

>purloin claw
[Purloined.]

>attack wasp
You can hardly do anything to the wasp like that.

>take claw
The claw attaches itself to one of your claws. Suddenly, it, and all your other claws, start growing, and turn from their normal white to a strange, metallic black. You feel dangerous.

* * *

>look
Wasp Hive
As you continue down the trail, you hear a faint buzzing, which gradually gets louder. Suddenly, three wasps surround you. You don't think you'll be able to proceed.

* * *

>w
Wasp Hive
As you continue down the trail, you hear a faint buzzing, which gradually gets louder. Suddenly, three wasps surround you. You don't think you'll be able to proceed.

>x wasp
You see nothing special about the wasp.

>attack wasp
You can hardly do anything to the wasp like that.

* * *

>look
Wasp Hive
As you continue down the trail, you hear a faint buzzing, which gradually gets louder. Suddenly, two wasps surround you. You don't think you'll be able to proceed.

>w
There are two wasps buzzing angrily at you. You won't be able to go that way.

>attack wasp
You claw the wasp into a thousand pieces.

>look
Wasp Hive
As you continue down the trail, you hear a faint buzzing, which gradually gets louder. Suddenly, one wasp surrounds you. You don't think you'll be able to proceed.

>attack wasp
You claw the wasp into a thousand pieces.

* * *

>look
Wasp Hive
As you continue down the trail, you hear a faint buzzing, which gradually gets louder. Suddenly, one wasp surrounds you. You don't think you'll be able to proceed.

>w
There is one wasp buzzing angrily at you. You won't be able to go that way.

* * *

>w
Wasp Hive
As you continue down the trail, you hear a faint buzzing, which gradually gets louder. Suddenly, three wasps surround you. You don't think you'll be able to proceed.

>e
Forest Entrance
As you proceed west, you enter a forest of tall beech trees. At first walking around seems easy, but you can see that the trees get thicker, and there are more and more bushes in the way.
There are two paths leading deeper into the forest. The trail to the west appears to be sloping down quite steeply. There's a sign next to it saying "DANGER! WASPS! There is another trail to the north. It appears that the trees are particularly trick that way.

>n
Thick Forest
The forest is getting so thick you can hardly walk around the trees, and when you do, you get stuck in the 

An extraordinary large mullein plant grows here. Its leaves are so large it seems they can support your weight.

>take leaf
Taken.

>w
Dark Forest
Trudging deeper in the forest, the canopy is letting very little pass trough, and it is getting hard to see.

>s
Wet Forest
A stream is rumbling along nearby. Now not only trees, but also reeds and water are in your way.

>n
Dark Forest
Trudging deeper in the forest, the canopy is letting very little pass trough, and it is getting hard to see.

>look
Dark Forest
Trudging deeper in the forest, the canopy is letting very little pass trough, and it is getting hard to see.

>take daffodil
You can't see any such thing.

* * *

>w
Wasp Hive
As you continue down the trail, you hear a faint buzzing, which gradually gets louder. Suddenly, three wasps surround you. You don't think you'll be able to proceed.

>purloin hiv
There seems to be no such object anywhere in the model world.

>purloin hive
[Can't move Wasp Hive: it would contain itself.]

>purloin claw
[Purloined.]

>take clow
You can't see any such thing.

>take claw
The claw attaches itself to one of your claws. Suddenly, it, and all your other claws, start growing, and turn from their normal white to a strange, metallic black. You feel dangerous.

>look
Wasp Hive
As you continue down the trail, you hear a faint buzzing, which gradually gets louder. Suddenly, three wasps surround you. You don't think you'll be able to proceed.

>attack wasp
You claw the wasp into a thousand pieces.

Violence isn't the answer to this one.

>look
Wasp Hive
As you continue down the trail, you hear a faint buzzing, which gradually gets louder. Suddenly, two wasps surround you. You don't think you'll be able to proceed.

>attack wasp
You claw the wasp into a thousand pieces.

Violence isn't the answer to this one.

>look
Wasp Hive
As you continue down the trail, you hear a faint buzzing, which gradually gets louder. Suddenly, one wasp surrounds you. You don't think you'll be able to proceed.

>attack wasp
You claw the wasp into a thousand pieces.

Violence isn't the answer to this one.

>look
Wasp Hive
As you continue down the trail,  you enjoy some peace and quiet. Down, beneath the trees, you can see the sparkling blue of lake water.

>look
Wasp Hive
As you continue down the trail,  you enjoy some peace and quiet. Down, beneath the trees, you can see the sparkling blue of lake water.

>take wasp wing
You can't see any such thing.

* * *

>w
Wasp Hive
As you continue down the trail, you hear a faint buzzing, which gradually gets louder. Suddenly, three wasps surround you. You don't think you'll be able to proceed.

>purloin claw
[Purloined.]

* * *

>w
Forest Entrance
As you proceed west, you enter a forest of tall beech trees. At first walking around seems easy, but you can see that the trees get thicker, and there are more and more bushes in the way.
There are two paths leading deeper into the forest. The trail to the west appears to be sloping down quite steeply. There's a sign next to it saying "DANGER! WASPS! There is another trail to the north. It appears that the trees are particularly trick that way.

>n
Thick Forest
The forest is getting so thick you can hardly walk around the trees, and when you do, you get stuck in the 

An extraordinary large mullein plant grows here. Its leaves are so large it seems they can support your weight.

* * *

>take leaf
Taken.

>w
Dark Forest
Trudging deeper in the forest, the canopy is letting very little pass trough, and it is getting hard to see.

You can see three daffodils here.

>s
Wet Forest
A stream is rumbling along nearby. Now not only trees, but also reeds and water are in your way.

>s
Forest Lake
You come accross a huge lake in the middle of the forest. To the west, in the lake's center, is an island, dominated by an oak so huge that its branches are reaching over the water. Lillies are scattered accross the lake's surface. A bunch of other flowers are littered on its banks.

>put leaf
(in the large leaf)
You can't put something inside itself.

>put leaf down
Dropped.

>get on leaf
You mount the large leaf.

>n
Wet Forest (on the large leaf)
A stream is rumbling along nearby. Now not only trees, but also reeds and water are in your way.

>s
Forest Lake (on the large leaf)
You come accross a huge lake in the middle of the forest. To the west, in the lake's center, is an island, dominated by an oak so huge that its branches are reaching over the water. Lillies are scattered accross the lake's surface. A bunch of other flowers are littered on its banks.

* * *

>w
Dark Forest
Trudging deeper in the forest, the canopy is letting very little pass trough, and it is getting hard to see.

You can see three daffodils here.

>take 3 daffodils
daffodil: Taken.
daffodil: Taken.
daffodil: Taken.

>s
Wet Forest
A stream is rumbling along nearby. Now not only trees, but also reeds and water are in your way.

* * *

>s
Forest Lake
You come accross a huge lake in the middle of the forest. To the west, in the lake's center, is an island, dominated by an oak so huge that its branches are reaching over the water. Lillies are scattered accross the lake's surface. A bunch of other flowers are littered on its banks.

>put leaf down
Dropped.

* * *

>get on leaf
You mount the large leaf.

>w
Unsurprisingly, the leaf doesn't quite move. Try saying "VROOM-VROOM", that'll TOTALLY work.

* * *

>w
Dark Forest
Trudging deeper in the forest, the canopy is letting very little pass trough, and it is getting hard to see.

You can see three daffodils here.

>take daffodils
daffodil: Taken.
daffodil: Taken.
daffodil: Taken.

>s
Wet Forest
A stream is rumbling along nearby. Now not only trees, but also reeds and water are in your way.

* * *

>s
Forest Lake
You come accross a huge lake in the middle of the forest. To the west, in the lake's center, is an island, dominated by an oak so huge that its branches are reaching over the water. Lillies are scattered accross the lake's surface. A bunch of other flowers are littered on its banks.

>drop leaf
Dropped.

>get on leaf
You mount the large leaf.

* * *

>w
Forest Entrance
As you proceed west, you enter a forest of tall beech trees. At first walking around seems easy, but you can see that the trees get thicker, and there are more and more bushes in the way.
There are two paths leading deeper into the forest. The trail to the west appears to be sloping down quite steeply. There's a sign next to it saying "DANGER! WASPS! There is another trail to the north. It appears that the trees are particularly trick that way.

>purloin claw
[Purloined.]

* * *

>take claw
The claw attaches itself to one of your claws. Suddenly, it, and all your other claws, start growing, and turn from their normal white to a strange, metallic black. You feel dangerous.

>n
Thick Forest
The forest is getting so thick you can hardly walk around the trees, and when you do, you get stuck in the 

An extraordinary large mullein plant grows here. Its leaves are so large it seems they can support your weight.

>e
You try to proceed, but are stopped by a wall of trees, bushes and brambles. This might not be the right way.

>e
You get lost in the forest, somehow getting back at the forest entrance.

Forest Entrance
As you proceed west, you enter a forest of tall beech trees. At first walking around seems easy, but you can see that the trees get thicker, and there are more and more bushes in the way.
There are two paths leading deeper into the forest. The trail to the west appears to be sloping down quite steeply. There's a sign next to it saying "DANGER! WASPS! There is another trail to the north. It appears that the trees are particularly trick that way.

>w
Wasp Hive
As you continue down the trail, you hear a faint buzzing, which gradually gets louder. Suddenly, three wasps surround you. You don't think you'll be able to proceed.

>attack wasp
You claw the wasp into a thousand pieces.

* * *

>take claw
The claw attaches itself to one of your claws. Suddenly, it, and all your other claws, start growing, and turn from their normal white to a strange, metallic black. You feel dangerous.

>w
Wasp Hive
As you continue down the trail, you hear a faint buzzing, which gradually gets louder. Suddenly, three wasps surround you. You don't think you'll be able to proceed.

* * *

>purloin carapace
There seems to be no such object anywhere in the model world.

>purloin wasp leg
There seems to be no such object anywhere in the model world.

>purloin wasp legs
[Purloined.]

>inv
You are carrying:
  Three wasp legs

* * *

>n
(first opening the dinky door)

Hill
You stand amid the golden wheat at the top of the hill. You can see the tavern's red roof, and the door to its garden. To the north, you can see a trail leading off into the mountains. To the west you see a forest in the distance.

>s
Garden
A number of sickly-looking vegetables grow around the garden of the tavern. A huge rosebush grows next to the wall of the tavern. A dinky door blocks a trail into the hill behind the tavern.

Through the green door's window you can see the tavern keeper still "cleaning" the same glass.

On the rosebush several roses are scattered like blotches of blood red paint.

>take rose
Taken.

>n
Hill
You stand amid the golden wheat at the top of the hill. You can see the tavern's red roof, and the door to its garden. To the north, you can see a trail leading off into the mountains. To the west you see a forest in the distance.

>w
Forest Entrance
As you proceed west, you enter a forest of tall beech trees. At first walking around seems easy, but you can see that the trees get thicker, and there are more and more bushes in the way.
There are two paths leading deeper into the forest. The trail to the west appears to be sloping down quite steeply. There's a sign next to it saying "DANGER! WASPS! There is another trail to the north. It appears that the trees are particularly trick that way.

* * *

>get on leaf
You mount the large leaf.

>w
Forest Island (on the large leaf)
Landing on the island in the middle of the lake, you are stunned by the largeness of the tree. It did seem big from the other side of the lake, but standing under it, you feel that it's almost impossibly huge, and incomprehensibly old.

On the bark you can see a tree hollow that's... closed with a door?

>give rose to nest
The catterpillars seem to like it!

You've taken good care of the caterpillars, and now it pays off. Fourteen of them crawl out of the nest and onto the doors of tree hollow. They plug in the little holes tightly. The wind, having nowhere to escape, now blows the doors open.

>take heart
The heart rises in the air, starts glowing, and turns into a ray of light that shoots straight at your heart. You feel a warm light spreading inside you. Your mind expands to new understanding and you feel you can now talk to people.

You've taken good care of the caterpillars, and now it pays off. Fourteen of them crawl out of the nest and onto the doors of tree hollow. They plug in the little holes tightly. The wind, having nowhere to escape, now blows the doors open.

* * *

>n
(first opening the dinky door)

Hill
You stand amid the golden wheat at the top of the hill. You can see the tavern's red roof, and the door to its garden. To the north, you can see a trail leading off into the mountains. To the west you see a forest in the distance.

>purloin claw
[Purloined.]

* * *

>take claw
The claw attaches itself to one of your claws. Suddenly, it, and all your other claws, start growing, and turn from their normal white to a strange, metallic black. You feel dangerous.

>w
Forest Entrance
As you proceed west, you enter a forest of tall beech trees. At first walking around seems easy, but you can see that the trees get thicker, and there are more and more bushes in the way.
There are two paths leading deeper into the forest. The trail to the west appears to be sloping down quite steeply. There's a sign next to it saying "DANGER! WASPS! There is another trail to the north. It appears that the trees are particularly trick that way.

* * *

>w
(first opening the green door)

Garden
A number of sickly-looking vegetables grow around the garden of the tavern. A huge rosebush grows next to the wall of the tavern. A dinky door blocks a trail into the hill behind the tavern.

Through the green door's window you can see the tavern keeper still "cleaning" the same glass.

On the rosebush several roses are scattered like blotches of blood red paint.

>take rose
Taken.

>take red rose
That's hardly portable.

* * *

>take rose
Taken.

>ACTIONS
Actions listing on.

>take rose
[taking the rose]
That's hardly portable.
[taking the rose - failed the can't take scenery rule]

* * *

>take rose
Taken.

>take rosebush
That's fixed in place.

* * *

>take rose
Taken.

>i
You are carrying:
  a rose

>ivn
That's not a verb I recognise.

>inv
You are carrying:
  a rose

>x rose
You see nothing special about the rose.

>look
Garden
A number of sickly-looking vegetables grow around the garden of the tavern. A huge rosebush grows next to the wall of the tavern. A dinky door blocks a trail into the hill behind the tavern.

Through the green door's window you can see the tavern keeper still "cleaning" the same glass.

On the rosebush are nine roses.

* * *

>i
You are carrying:
  a rose

>take rose
Taken.

>i
You are carrying:
  two roses

* * *

>take rose
Taken.

>take rose
Taken.

>n
(first opening the dinky door)

Hill
You stand amid the golden wheat at the top of the hill. You can see the tavern's red roof, and the door to its garden. To the north, you can see a trail leading off into the mountains. To the west you see a forest in the distance.

* * *

>w
Forest Entrance
As you proceed west, you enter a forest of tall beech trees. At first walking around seems easy, but you can see that the trees get thicker, and there are more and more bushes in the way.
There are two paths leading deeper into the forest. The trail to the west appears to be sloping down quite steeply. There's a sign next to it saying "DANGER! WASPS! There is another trail to the north. It appears that the trees are particularly trick that way.

>s
You can't go that way.

>n
Thick Forest
The forest is getting so thick you can hardly walk around the trees, and when you do, you get stuck in the 

An extraordinary large mullein plant grows here. Its leaves are so large it seems they can support your weight.

>s
Forest Entrance
As you proceed west, you enter a forest of tall beech trees. At first walking around seems easy, but you can see that the trees get thicker, and there are more and more bushes in the way.
There are two paths leading deeper into the forest. The trail to the west appears to be sloping down quite steeply. There's a sign next to it saying "DANGER! WASPS! There is another trail to the south. It appears that the trees are particularly trick that way.

>n
Thick Forest
The forest is getting so thick you can hardly walk around the trees, and when you do, you get stuck in the 

An extraordinary large mullein plant grows here. Its leaves are so large it seems they can support your weight.

>e
You get lost in the forest, somehow getting back at the forest entrance.

Forest Entrance
As you proceed west, you enter a forest of tall beech trees. At first walking around seems easy, but you can see that the trees get thicker, and there are more and more bushes in the way.
There are two paths leading deeper into the forest. The trail to the west appears to be sloping down quite steeply. There's a sign next to it saying "DANGER! WASPS! There is another trail to the south. It appears that the trees are particularly trick that way.

>n
Thick Forest
The forest is getting so thick you can hardly walk around the trees, and when you do, you get stuck in the 

An extraordinary large mullein plant grows here. Its leaves are so large it seems they can support your weight.

>w
Dark Forest
Trudging deeper in the forest, the canopy is letting very little pass trough, and it is getting hard to see.

>n
You try to proceed, but are stopped by a wall of trees, bushes and brambles. This might not be the right way.

>w
You try to proceed, but are stopped by a wall of trees, bushes and brambles. This might not be the right way.

>s
Wet Forest
A stream is rumbling along nearby. Now not only trees, but also reeds and water are in your way.

* * *

>n
Dark Forest
Trudging deeper in the forest, the canopy is letting very little pass trough, and it is getting hard to see.

>e
Thick Forest
The forest is getting so thick you can hardly walk around the trees, and when you do, you get stuck in the 

An extraordinary large mullein plant grows here. Its leaves are so large it seems they can support your weight.

>take leaf
Taken.

>inv
You are carrying:
  a large leaf
  a rose

>w
Dark Forest
Trudging deeper in the forest, the canopy is letting very little pass trough, and it is getting hard to see.

* * *

>get on leaf
You mount the large leaf.

>w
Forest Island (on the large leaf)

>get off
You dismount the large leaf.

Forest Island
You can see a large leaf here.

>get on leaf
You mount the large leaf.

>e
Forest Lake (on the large leaf)
You come accross a huge lake in the middle of the forest. To the west, in the lake's center, is an island, dominated by an oak so huge that its branches are reaching over the water. Lillies are scattered accross the lake's surface. A bunch of other flowers are littered on its banks.

>exit
You dismount the large leaf.

Forest Lake
You come accross a huge lake in the middle of the forest. To the west, in the lake's center, is an island, dominated by an oak so huge that its branches are reaching over the water. Lillies are scattered accross the lake's surface. A bunch of other flowers are littered on its banks.

You can see a large leaf here.

>take leaf
Taken.

>w
You need to cross the lake somehow.

>purloin wing
[Purloined.]

* * *

>take wing
The wing is suddenly picked up by a gust of wind. It floats in the air, until landing softly on your back. You feel it splitting in two, and attaching the halves behind your shoulder plates. The process is not painful, takes only a couple of minutes, and then you feel lighter.

>w
You rise up in the air on your scaly wings, and fly over the lake.

>l
Forest Lake
You come accross a huge lake in the middle of the forest. To the west, in the lake's center, is an island, dominated by an oak so huge that its branches are reaching over the water. Lillies are scattered accross the lake's surface. A bunch of other flowers are littered on its banks.

>drop leaf
Dropped.

* * *

>get off
You dismount the large leaf.

Forest Island
You can see a large leaf here.

>e
You rise up in the air on your scaly wings, and fly over the lake.

Forest Lake
You come accross a huge lake in the middle of the forest. To the west, in the lake's center, is an island, dominated by an oak so huge that its branches are reaching over the water. Lillies are scattered accross the lake's surface. A bunch of other flowers are littered on its banks.

>w
You rise up in the air on your scaly wings, and fly over the lake.

>purloin leaf
[Purloined.]

>inv
You are carrying:
  a large leaf
  a rose

>l
Forest Lake
You come accross a huge lake in the middle of the forest. To the west, in the lake's center, is an island, dominated by an oak so huge that its branches are reaching over the water. Lillies are scattered accross the lake's surface. A bunch of other flowers are littered on its banks.

>s
You can't go that way.

>n
Wet Forest
A stream is rumbling along nearby. Now not only trees, but also reeds and water are in your way.

>drop leaf
Dropped.

* * *

>get on leaf
You mount the large leaf.

>s
Forest Lake (on the large leaf)
You come accross a huge lake in the middle of the forest. To the west, in the lake's center, is an island, dominated by an oak so huge that its branches are reaching over the water. Lillies are scattered accross the lake's surface. A bunch of other flowers are littered on its banks.

* * *

>take leaf
Taken.

>w
You get lost in the forest, somehow getting back at the forest entrance.

Forest Entrance
As you proceed west, you enter a forest of tall beech trees. At first walking around seems easy, but you can see that the trees get thicker, and there are more and more bushes in the way.
There are two paths leading deeper into the forest. The trail to the west appears to be sloping down quite steeply. There's a sign next to it saying "DANGER! WASPS! There is another trail to the north. It appears that the trees are particularly trick that way.

>n
Thick Forest
The forest is getting so thick you can hardly walk around the trees, and when you do, you get stuck in the

>n
Dark Forest
Trudging deeper in the forest, the canopy is letting very little pass trough, and it is getting hard to see.

You can see three daffodils here.

>w
Wet Forest
A stream is rumbling along nearby. Now not only trees, but also reeds and water are in your way.

>s
Forest Lake
You come accross a huge lake in the middle of the forest. To the west, in the lake's center, is an island, dominated by an oak so huge that its branches are reaching over the water. Lillies are scattered accross the lake's surface. A bunch of other flowers are littered on its banks.

* * *

>take leaf
Taken.

>drop leaf
Dropped.

* * *

>get on leaf
You mount the large leaf.

>s
Unsurprisingly, the leaf doesn't quite move. Try saying "VROOM-VROOM", that'll TOTALLY work.

>get off
You dismount the large leaf.

Thick Forest
The forest is getting so thick you can hardly walk around the trees, and when you do, you get stuck in the 

You can see a large leaf here.

>take leaf
Taken.

* * *

>w
You get lost in the forest, somehow getting back at the forest entrance.

Forest Entrance
As you proceed west, you enter a forest of tall beech trees. At first walking around seems easy, but you can see that the trees get thicker, and there are more and more bushes in the way.
There are two paths leading deeper into the forest. The trail to the west appears to be sloping down quite steeply. There's a sign next to it saying "DANGER! WASPS! There is another trail to the north. It appears that the trees are particularly trick that way.

>s
You can't go that way.

>n
Thick Forest
The forest is getting so thick you can hardly walk around the trees, and when you do, you get stuck in the

* * *

>n
Thick Forest
The forest is getting so thick you can hardly walk around the trees, and when you do, you get stuck in the 

An extraordinary large mullein plant grows here. Its leaves are so large it seems they can support your weight.

>w
You get lost in the forest, somehow getting back at the forest entrance.

Forest Entrance
As you proceed west, you enter a forest of tall beech trees. At first walking around seems easy, but you can see that the trees get thicker, and there are more and more bushes in the way.
There are two paths leading deeper into the forest. The trail to the west appears to be sloping down quite steeply. There's a sign next to it saying "DANGER! WASPS! There is another trail to the north. It appears that the trees are particularly trick that way.

* * *

>take leaf
Taken.

>w
You try to proceed, but are stopped by a wall of trees, bushes and brambles. This might not be the right way.

>s
Forest Entrance
As you proceed west, you enter a forest of tall beech trees. At first walking around seems easy, but you can see that the trees get thicker, and there are more and more bushes in the way.
There are two paths leading deeper into the forest. The trail to the west appears to be sloping down quite steeply. There's a sign next to it saying "DANGER! WASPS! There is another trail to the north. It appears that the trees are particularly trick that way.

>n
Thick Forest
The forest is getting so thick you can hardly walk around the trees, and when you do, you get stuck in the

* * *

>take rose
Taken.

>purloin leaf
[Purloined.]

>drop leaf
Dropped.

* * *

>get on leaf
You mount the large leaf.

>n
Unsurprisingly, the leaf doesn't quite move. Try saying "VROOM-VROOM", that'll TOTALLY work.

>get off
You dismount the large leaf.

Garden
A number of sickly-looking vegetables grow around the garden of the tavern. A huge rosebush grows next to the wall of the tavern. A dinky door blocks a trail into the hill behind the tavern.

Through the green door's window you can see the tavern keeper still "cleaning" the same glass.

On the rosebush several roses are scattered like blotches of blood red paint.

You can also see a large leaf here.

>take leaf
Taken.

>n
(first opening the dinky door)

Hill
You stand amid the golden wheat at the top of the hill. You can see the tavern's red roof, and the door to its garden. To the north, you can see a trail leading off into the mountains. To the west you see a forest in the distance.

* * *

>w
Forest Entrance
As you proceed west, you enter a forest of tall beech trees. At first walking around seems easy, but you can see that the trees get thicker, and there are more and more bushes in the way.
There are two paths leading deeper into the forest. The trail to the west appears to be sloping down quite steeply. There's a sign next to it saying "DANGER! WASPS! There is another trail to the north. It appears that the trees are particularly trick that way.

>n
Thick Forest
The forest is getting so thick you can hardly walk around the trees, and when you do, you get stuck in the

* * *

>get on leaf
You mount the large leaf.

>l
Forest Lake (on the large leaf)
You come accross a huge lake in the middle of the forest. To the west, in the lake's center, is an island, dominated by an oak so huge that its branches are reaching over the water. Lillies are scattered accross the lake's surface. A bunch of other flowers are littered on its banks.

>w
Forest Island (on the large leaf)
Landing on the island in the middle of the lake, you are stunned by the largeness of the tree. It did seem big from the other side of the lake, but standing under it, you feel that it's almost impossibly huge, and incomprehensibly old.

On the bark you can see a tree hollow that's... closed with a door?

>inv
You are carrying:
  a rose

>get off
You dismount the large leaf.

Forest Island
Landing on the island in the middle of the lake, you are stunned by the largeness of the tree. It did seem big from the other side of the lake, but standing under it, you feel that it's almost impossibly huge, and incomprehensibly old.

On the bark you can see a tree hollow that's... closed with a door?

You can also see a large leaf here.

>give rose to nest
The catterpillars seem to like it!

You've taken good care of the caterpillars, and now it pays off. Fourteen of them crawl out of the nest and onto the doors of tree hollow. They plug in the little holes tightly. The wind, having nowhere to escape, now blows the doors open.

>l
Forest Island
Landing on the island in the middle of the lake, you are stunned by the largeness of the tree. It did seem big from the other side of the lake, but standing under it, you feel that it's almost impossibly huge, and incomprehensibly old.

The tree hollow's gates are swinging freely in the wind.

You can also see a large leaf here.

A bird of prey appears from between the trees.

>atack bird
That's not a verb I recognise.

>attack bird
You stand your ground against the bird. It flies away, cawing loudly.

A bird of prey appears from between the trees.

* * *

>take rose
Taken.

>w
You can't go that way.

>n
(first opening the dinky door)

Hill
You stand amid the golden wheat at the top of the hill. You can see the tavern's red roof, and the door to its garden. To the north, you can see a trail leading off into the mountains. To the west you see a forest in the distance.

* * *

>take claw
The claw attaches itself to one of your claws. Suddenly, it, and all your other claws, start growing, and turn from their normal white to a strange, metallic black. You feel dangerous.

>attack claw
You can't see any such thing.

* * *

>w
(first opening the green door)

Garden
A number of sickly-looking vegetables grow around the garden of the tavern. A huge rosebush grows next to the wall of the tavern. A dinky door blocks a trail into the hill behind the tavern.

Through the green door's window you can see the tavern keeper still "cleaning" the same glass.

On the rosebush several roses are scattered like blotches of blood red paint.

>w
You can't go that way.

>take rose
(the rose bush)
That's fixed in place.

* * *

>w
You can't go that way.

>b
That's not a verb I recognise.

>n
(first opening the dinky door)

Hill
You stand amid the golden wheat at the top of the hill. You can see the tavern's red roof, and the door to its garden. To the north, you can see a trail leading off into the mountains. To the west you see a forest in the distance.

* * *

>take leaf
Taken.

>put leaf down
Dropped.

* * *

>get on leaf
You mount the large leaf.

>w
Dark Forest (on the large leaf)
Trudging deeper in the forest, the canopy is letting very little pass trough, and it is getting hard to see.

You can see three daffodils here.

>take daffodils
daffodil: Taken.
daffodil: Taken.
daffodil: Taken.

>s
Wet Forest (on the large leaf)
A stream is rumbling along nearby. Now not only trees, but also reeds and water are in your way.

>s
Forest Lake (on the large leaf)
You come accross a huge lake in the middle of the forest. To the west, in the lake's center, is an island, dominated by an oak so huge that its branches are reaching over the water. Lillies are scattered accross the lake's surface. A bunch of other flowers are littered on its banks.

>w
Forest Island (on the large leaf)
Landing on the island in the middle of the lake, you are stunned by the largeness of the tree. It did seem big from the other side of the lake, but standing under it, you feel that it's almost impossibly huge, and incomprehensibly old.

On the bark you can see a tree hollow that's... closed with a door?

>examine hollow
You see nothing special about the tree hollow.

>examine holes
You see nothing special about the holes.

>examine branch
On the branch is a nest of caterpillars.

>examine nest
You see nothing special about the nest of caterpillars.

>look nest
You see nothing special about the nest of caterpillars.

>give rose to nest
You can't see any such thing.

>give daffodil to nest
You can only do that to something animate.

* * *

>w
(first opening the green door)

Garden
A number of sickly-looking vegetables grow around the garden of the tavern. A huge rosebush grows next to the wall of the tavern. A dinky door blocks a trail into the hill behind the tavern.

Through the green door's window you can see the tavern keeper still "cleaning" the same glass.

On the rosebush several roses are scattered like blotches of blood red paint.

>take 9 roses
rose: Taken.
rose: Taken.
rose: Taken.
rose: Taken.
rose: Taken.
rose: Taken.
rose: Taken.
rose: Taken.
rose: Taken.

>inv
You are carrying:
  nine roses

>look
Garden
A number of sickly-looking vegetables grow around the garden of the tavern. A huge rosebush grows next to the wall of the tavern. A dinky door blocks a trail into the hill behind the tavern.

Through the green door's window you can see the tavern keeper still "cleaning" the same glass.

On the rosebush a single rose is drawing the eye, its petals the colour of blood.

>l
Garden
A number of sickly-looking vegetables grow around the garden of the tavern. A huge rosebush grows next to the wall of the tavern. A dinky door blocks a trail into the hill behind the tavern.

Through the green door's window you can see the tavern keeper still "cleaning" the same glass.

On the rosebush a single rose is drawing the eye, its petals the colour of blood.

* * *

>w
(first opening the green door)

Garden
A number of sickly-looking vegetables grow around the garden of the tavern. A huge rosebush grows next to the wall of the tavern. A dinky door blocks a trail into the hill behind the tavern.

Through the green door's window you can see the tavern keeper still "cleaning" the same glass.

On the rosebush several roses are scattered like blotches of blood red paint.

>e
Tavern
You are in a large room with several long wooden tables with benches, and a bar. Next to it you can see a stairway leading down. A large oaken log is slowly burning in the fireplace, producing more heat than light. Shadows dance around the room, barely lighting the faces of the people here. 

Next to the far side of the bar, on the west side of the tavern, there is a green door with a circular window, apparently leading to the garden.

A door made out of brown logs held together by metal rings is on the south wall. The coat rack and the welcome mat next to it suggest it is the front door.

A surly, bald man stands behind the bar, absent-mindedly washing a glass with an extremely dirty cloth.

A tall man wearing a long, gray cloak and eyepatch is sitting, cross-legged, next to the fire. He is carrying a long staff. Many silver hairs shimmer in his otherwise dark beard. A raven is sitting on his shoulder. He seems like a person that would be worthwile to listen to.

Above the fireplace hangs a peculiar engraving of a bird that appears to be on fire. You notice that occasionally the tall man throws a look at it and appears very thoughtful.

>s
(first opening the front door)

Front Lawn
Outside the tavern, you see it is a large building painted white, with a red roof and a small brick chimney.
There is a large empty space on which several carts are parked.
A wide dirt road stretches in front of you. To the east a large statue towers in the middle of the village square with. To the west you can see a tall metal fence surrounding a number of graves overgrown with ivy, with a mausoleum made of white stone in the back of it.

A door made out of brown logs held together by metal rings is on the wall of the Tavern.

* * *

>w
Graveyard Entrance
You can see a metal door here.

>purloin wing
[Purloined.]

* * *

>take wing
The wing is suddenly picked up by a gust of wind. It floats in the air, until landing softly on your back. You feel it splitting in two, and attaching the halves behind your shoulder plates. The process is not painful, takes only a couple of minutes, and then you feel lighter.

>s
You spread your wings and fly over the metal bars.

Graves
The graves here are dillapidated, nearly crumbling, and covered with ivy and various weeds. The villagers don't seem to be taking much care of them. 

A heavy stone door blocks the entrance to the mausoleum.

You can also see a metal door here.

>look
Graves
The graves here are dillapidated, nearly crumbling, and covered with ivy and various weeds. The villagers don't seem to be taking much care of them. 

A heavy stone door blocks the entrance to the mausoleum.

You can also see a metal door here.

* * *

I beg your pardon?

>w
(first opening the green door)

Garden
A number of sickly-looking vegetables grow around the garden of the tavern. A huge rosebush grows next to the wall of the tavern. A dinky door blocks a trail into the hill behind the tavern.

Through the green door's window you can see the tavern keeper still "cleaning" the same glass.

On the rosebush several roses are scattered like blotches of blood red paint.

>look bush
On the rosebush Several roses are scattered like blotches of blood red paint through the bush.
.

* * *

>w
Unsurprisingly, the leaf doesn't quite move. Try saying "VROOM-VROOM", that'll TOTALLY work.

>get off
You dismount the large leaf.

Thick Forest
The forest is getting so thick you can hardly walk around the trees, and when you do, you get stuck in the 

You can see a large leaf here.

* * *

>take leaf
Taken.

I beg your pardon?

>w
Dark Forest
Trudging deeper in the forest, the canopy is letting very little pass trough, and it is getting hard to see.

You can see three daffodils here.

* * *

>purloin leaf
[Purloined.]

>drop laef
You can't see any such thing.

>drop leaf
Dropped.

>s
(first opening the front door)

Front Lawn
Outside the tavern, you see it is a large building painted white, with a red roof and a small brick chimney.
There is a large empty space on which several carts are parked.
A wide dirt road stretches in front of you. To the east a large statue towers in the middle of the village square with. To the west you can see a tall metal fence surrounding a number of graves overgrown with ivy, with a mausoleum made of white stone in the back of it.

A door made out of brown logs held together by metal rings is on the wall of the Tavern.

>n
Tavern
You are in a large room with several long wooden tables with benches, and a bar. A large oaken log is slowly burning in the fireplace, producing more heat than light. Shadows dance around the room, barely lighting the faces of the people here. 

A door made out of brown logs held together by metal rings is on the south wall. The coat rack and the welcome mat next to it suggest it is the front door.

Next to the far side of the bar, on the west side of the tavern, there is a green door with a circular window, apparently leading to the garden.

A surly, bald man stands behind the bar, absent-mindedly washing a glass with an extremely dirty cloth.

A tall man wearing a long, gray cloak and eyepatch is sitting, cross-legged, next to the fire. He is carrying a long staff. Many silver hairs shimmer in his otherwise dark beard. A raven is sitting on his shoulder.

Above the fireplace hangs a peculiar engraving of a bird that appears to be on fire. You notice that occasionally the tall man throws a look at it and appears very thoughtful.

You can also see a large leaf and a bird of prey here.

>get on leaf
You mount the large leaf.

>s
Front Lawn (on the large leaf)
Outside the tavern, you see it is a large building painted white, with a red roof and a small brick chimney.
There is a large empty space on which several carts are parked.
A wide dirt road stretches in front of you. To the east a large statue towers in the middle of the village square with. To the west you can see a tall metal fence surrounding a number of graves overgrown with ivy, with a mausoleum made of white stone in the back of it.

A door made out of brown logs held together by metal rings is on the wall of the Tavern.

* * *

>attack Odin
You don't think the stranger is threatening.

>w
(first opening the green door)

Garden
A number of sickly-looking vegetables grow around the garden of the tavern. A huge rosebush grows next to the wall of the tavern. A dinky door blocks a trail into the hill behind the tavern.

Through the green door's window you can see the tavern keeper still "cleaning" the same glass.

On the rosebush several roses are scattered like blotches of blood red paint.

* * *

>take claw
The claw attaches itself to one of your claws. Suddenly, it, and all your other claws, start growing, and turn from their normal white to a strange, metallic black. You feel dangerous.

>attack wasp
You claw the wasp into a thousand pieces.
The wasp's carapace falls next to its lifeless body

>look
Wasp Hive
As you continue down the trail, you hear a faint buzzing, which gradually gets louder. Suddenly, two wasps surround you. You don't think you'll be able to proceed.

You can see a carapace here.

>attack wasp
You claw the wasp into a thousand pieces.
The wasp's carapace falls next to its lifeless body

>attack wasp
You claw the wasp into a thousand pieces.
The wasp's carapace falls next to its lifeless body

>look
Wasp Hive
As you continue down the trail,  you enjoy some peace and quiet. Down, beneath the trees, you can see the sparkling blue of lake water.

You can see three carapaces here.

>hint
That's not a verb I recognise.

>help
That's not a verb I recognise.

* * *

>listen to stranger
The stranger looks at you, then turns his gaze to the engraving.

"They say the phoenix is reborn again, after it dies, pup.", he starts. "And that is true.".

"And yet, here it is, turned into a lifeless representation of what it once was."

"Everything is made of base parts, and the phoenix is no exception."

"Some time ago, its essence got taken from it. I don't know how, or who did it - I only found out when it was too late."

"I do know, however, that the phoenix's parts - its heart, wing, ash, and claw, are here."

"Find them. Come back here. Touch the engraving. I'll make sure to return you to your home, with the reward you deserve."

* * *

>listen to stranger
Having trouble navigating the forest? Listen to my raven, he knows the way.

>listen to stranger
Helping others is a reward in itself, but may provide you with actual rewards, if you are persistent enough.

* * *

>listen to stranger
Get the claw.

* * *

>listen to stranger
The wing is in the mountains.

>listen to stranger
Having trouble navigating the forest? Listen to my raven, he knows the way.

* * *

>listen to stranger
Helping others is a reward in itself, but may provide you with actual rewards, if you are persistent enough.

>listen to stranger
To cross the lake, find something to carry your weight.

>showme table of hints
There seems to be no such object anywhere in the model world.

* * *

>down
You manage to sneak by the tavern keeper and go downstairs.

Basement
Jars, bottles, crates and boxes of all kinds are scattered around the basement.

A hunk of yellow cheese is sitting on one of the boxes.

Something is shimmering on a crate in the furthest corner. On closer inspection it seems to be an iron key with a round end.

>up
Tavern
You are in a large room with several long wooden tables with benches, and a bar. Next to it you can see a stairway leading down. A large oaken log is slowly burning in the fireplace, producing more heat than light. Shadows dance around the room, barely lighting the faces of the people here. 

Next to the far side of the bar, on the west side of the tavern, there is a green door with a circular window, apparently leading to the garden.

A door made out of brown logs held together by metal rings is on the south wall. The coat rack and the welcome mat next to it suggest it is the front door.

A surly, bald man stands behind the bar, absent-mindedly washing a glass with an extremely dirty cloth.

A tall man wearing a long, gray cloak and eyepatch is sitting, cross-legged, next to the fire. He is carrying a long staff. Many silver hairs shimmer in his otherwise dark beard. A raven is sitting on his shoulder. He seems like a person that would be worthwile to listen to.

Above the fireplace hangs a peculiar engraving of a bird that appears to be on fire. You notice that occasionally the tall man throws a look at it and appears very thoughtful.

>down
The barkeep glares at you.

>down
The barkeep glares at you.

>up
You can't go that way.

>purloin bottle of wine
[Purloined.]

>give bottle of wine to barkeep
The barkeep grunts something in thanks, then nods towards the staircase.

>down
The barkeep nods at you.

Basement
Jars, bottles, crates and boxes of all kinds are scattered around the basement.

A hunk of yellow cheese is sitting on one of the boxes.

Something is shimmering on a crate in the furthest corner. On closer inspection it seems to be an iron key with a round end.

>wait 3 hours
I only understood you as far as wanting to wait.

>wait for 3 hours
I only understood you as far as wanting to wait.

>wait
Time passes.

>wait
Time passes.

>wait until 12 am
I only understood you as far as wanting to wait.

* * *

>s
(first opening the front door)

Front Lawn
Outside the tavern, you see it is a large building painted white, with a red roof and a small brick chimney.
There is a large empty space on which several carts are parked.
A wide dirt road stretches in front of you. To the east a large statue towers in the middle of the village square with. To the west you can see a tall metal fence surrounding a number of graves overgrown with ivy, with a mausoleum made of white stone in the back of it.

A door made out of brown logs held together by metal rings is on the wall of the Tavern.

* * *

>w
Graveyard Entrance
You can see a metal door here.

>purloin round iron key
[Purloined.]

>unlock door
(with the round iron key)
You unlock the metal door.

>s
(first opening the metal door)

Graves
The graves here are dillapidated, nearly crumbling, and covered with ivy and various weeds. The villagers don't seem to be taking much care of them. 

You can see a metal door here.

>look
Graves
The graves here are dillapidated, nearly crumbling, and covered with ivy and various weeds. The villagers don't seem to be taking much care of them. 

You can see a metal door here.

>attack zombies
You can't see any such thing.

>attack zombie
You can't see any such thing.

* * *

>take wing
The wing is suddenly picked up by a gust of wind. It floats in the air, until landing softly on your back. You feel it splitting in two, and attaching the halves behind your shoulder plates. The process is not painful, takes only a couple of minutes, and then you feel lighter.

>s
You spread your wings and fly over the metal bars.

Graves
The graves here are dillapidated, nearly crumbling, and covered with ivy and various weeds. The villagers don't seem to be taking much care of them. 

A heavy stone door blocks the entrance to the mausoleum. A weird stone plaque with some odd, geometric-shaped depressions, is on the door. There are a round plate, a square plate, a triangle plate and a hexagon plate

You can also see a metal door and two zombies here.

>l
Graves
The graves here are dillapidated, nearly crumbling, and covered with ivy and various weeds. The villagers don't seem to be taking much care of them. 

A heavy stone door blocks the entrance to the mausoleum. A weird stone plaque with some odd, geometric-shaped depressions, is on the door. There are a round plate, a square plate, a triangle plate and a hexagon plate

You can also see a metal door and two zombies here.

>attack zombi
You can't see any such thing.

>attack zombie
You can hardly do anything to the zombie like that.

>n
You spread your wings and fly over the metal bars.

Graveyard Entrance
You can see a metal door here.

>purloin claw
[Purloined.]

* * *

>take claw
The claw attaches itself to one of your claws. Suddenly, it, and all your other claws, start growing, and turn from their normal white to a strange, metallic black. You feel dangerous.

>s
You spread your wings and fly over the metal bars.

Graves
The graves here are dillapidated, nearly crumbling, and covered with ivy and various weeds. The villagers don't seem to be taking much care of them. 

A heavy stone door blocks the entrance to the mausoleum. A weird stone plaque with some odd, geometric-shaped depressions, is on the door. There are a round plate, a square plate, a triangle plate and a hexagon plate

You can also see a metal door and two zombies here.

>attack zombie
You claw and claw, but it doesn't seem to stop the zombie menace.

>look
Graves
The graves here are dillapidated, nearly crumbling, and covered with ivy and various weeds. The villagers don't seem to be taking much care of them. 

A heavy stone door blocks the entrance to the mausoleum. A weird stone plaque with some odd, geometric-shaped depressions, is on the door. There are a round plate, a square plate, a triangle plate and a hexagon plate

You can also see a metal door and two zombies here.

>n
You spread your wings and fly over the metal bars.

Graveyard Entrance
You can see a metal door here.

>purloin ash
[Purloined.]

>take ash
You try carefully picking the ash in your maw, but swallow it accidentally. Your intestines feel like they're on fire, and you wonder if your muzzle will fall off from the pain. Eventually the pain subsides. The fire, on the other hand, doesn't...

>s
You spread your wings and fly over the metal bars.

Graves
The graves here are dillapidated, nearly crumbling, and covered with ivy and various weeds. The villagers don't seem to be taking much care of them. 

A heavy stone door blocks the entrance to the mausoleum. A weird stone plaque with some odd, geometric-shaped depressions, is on the door. There are a round plate, a square plate, a triangle plate and a hexagon plate

You can also see a metal door and two zombies here.

>burn zombie
You burn the zombie to crisps.

>look
Graves
The graves here are dillapidated, nearly crumbling, and covered with ivy and various weeds. The villagers don't seem to be taking much care of them. 

A heavy stone door blocks the entrance to the mausoleum. A weird stone plaque with some odd, geometric-shaped depressions, is on the door. There are a round plate, a square plate, a triangle plate and a hexagon plate

You can also see a metal door and a zombie here.

>burn zombie
You burn the zombie to crisps.

>look
Graves
The graves here are dillapidated, nearly crumbling, and covered with ivy and various weeds. The villagers don't seem to be taking much care of them. 

A heavy stone door blocks the entrance to the mausoleum. A weird stone plaque with some odd, geometric-shaped depressions, is on the door. There are a round plate, a square plate, a triangle plate and a hexagon plate

You can also see a metal door here.

>push square plate
The plate slides backwards and falls down somewhere. You hear a thunderclap behind you. Another zombie shows up behind you, seemingly from nowhere.

>look
Graves
The graves here are dillapidated, nearly crumbling, and covered with ivy and various weeds. The villagers don't seem to be taking much care of them. 

A heavy stone door blocks the entrance to the mausoleum. A weird stone plaque with some odd, geometric-shaped depressions, is on the door. There are a round plate, a triangle plate and a hexagon plate

You can also see a zombie and a metal door here.

>burn zombie
You burn the zombie to crisps.

>push round plate
The plate slides backwards and falls down somewhere. You hear a thunderclap behind you. Another zombie shows up behind you, seemingly from nowhere.

>burn zombie
You burn the zombie to crisps.

>push triangle plate
The plate slides backwards and falls down somewhere. You hear a thunderclap behind you. Another zombie shows up behind you, seemingly from nowhere.

>burn zombie
You burn the zombie to crisps.

>push hexagon plate
The plate slides backwards and falls down somewhere.

>look
Graves
The graves here are dillapidated, nearly crumbling, and covered with ivy and various weeds. The villagers don't seem to be taking much care of them. 

The stone door is open to the side.

You can also see a metal door here.

>enter mausoleum
You can't see any such thing.

>in
Mausoleum
The stone door is open to the side.

* * *

>s
(first opening the front door)

Front Lawn
Outside the tavern, you see it is a large building painted white, with a red roof and a small brick chimney.
There is a large empty space on which several carts are parked.
A wide dirt road stretches in front of you. To the east a large statue towers in the middle of the village square with. To the west you can see a tall metal fence surrounding a number of graves overgrown with ivy, with a mausoleum made of white stone in the back of it.

A door made out of brown logs held together by metal rings is on the wall of the Tavern.

>n
Tavern
You are in a large room with several long wooden tables with benches, and a bar. Next to it you can see a stairway leading down. A large oaken log is slowly burning in the fireplace, producing more heat than light. Shadows dance around the room, barely lighting the faces of the people here. 

A door made out of brown logs held together by metal rings is on the south wall. The coat rack and the welcome mat next to it suggest it is the front door.

Next to the far side of the bar, on the west side of the tavern, there is a green door with a circular window, apparently leading to the garden.

A surly, bald man stands behind the bar, absent-mindedly washing a glass with an extremely dirty cloth.

A tall man wearing a long, gray cloak and eyepatch is sitting, cross-legged, next to the fire. He is carrying a long staff. Many silver hairs shimmer in his otherwise dark beard. A raven is sitting on his shoulder. He seems like a person that would be worthwile to listen to.

Above the fireplace hangs a peculiar engraving of a bird that appears to be on fire. You notice that occasionally the tall man throws a look at it and appears very thoughtful.

>d
You manage to sneak by the tavern keeper and go downstairs.

Basement
Jars, bottles, crates and boxes of all kinds are scattered around the basement.

A hunk of yellow cheese is sitting on one of the boxes.

Something is shimmering on a crate in the furthest corner. On closer inspection it seems to be an iron key with a round end.

>d
You can't go that way.

>d
You can't go that way.

>take key
Taken.

>up
Tavern
You are in a large room with several long wooden tables with benches, and a bar. Next to it you can see a stairway leading down. A large oaken log is slowly burning in the fireplace, producing more heat than light. Shadows dance around the room, barely lighting the faces of the people here. 

A door made out of brown logs held together by metal rings is on the south wall. The coat rack and the welcome mat next to it suggest it is the front door.

Next to the far side of the bar, on the west side of the tavern, there is a green door with a circular window, apparently leading to the garden.

A surly, bald man stands behind the bar, absent-mindedly washing a glass with an extremely dirty cloth.

A tall man wearing a long, gray cloak and eyepatch is sitting, cross-legged, next to the fire. He is carrying a long staff. Many silver hairs shimmer in his otherwise dark beard. A raven is sitting on his shoulder. He seems like a person that would be worthwile to listen to.

Above the fireplace hangs a peculiar engraving of a bird that appears to be on fire. You notice that occasionally the tall man throws a look at it and appears very thoughtful.

* * *

>s
Front Lawn
Outside the tavern, you see it is a large building painted white, with a red roof and a small brick chimney.
There is a large empty space on which several carts are parked.
A wide dirt road stretches in front of you. To the east a large statue towers in the middle of the village square with. To the west you can see a tall metal fence surrounding a number of graves overgrown with ivy, with a mausoleum made of white stone in the back of it.

A door made out of brown logs held together by metal rings is on the wall of the Tavern.

>w
Graveyard Entrance
A door of old, yellowed iron, with a heavy padlock, is barring the entrance to the cemetary. The padlock is locked.

>unlock door
(with the round iron key)
You unlock the metal door.

>look
Graveyard Entrance
A door of old, yellowed iron, with a heavy padlock, is barring the entrance to the cemetary. The padlock is unlocked.

>s
(first opening the metal door)

Graves
The graves here are dillapidated, nearly crumbling, and covered with ivy and various weeds. The villagers don't seem to be taking much care of them. 

A door of old, yellowed iron, with a heavy padlock, is barring the entrance to the cemetary. The padlock is unlocked.

A heavy stone door blocks the entrance to the mausoleum. A weird stone plaque with some odd, geometric-shaped depressions, is on the door. There are a round plate, a square plate, a triangle plate and a hexagon plate

You can also see two zombies here.

>n
Graveyard Entrance
A door of old, yellowed iron, with a heavy padlock, is barring the entrance to the cemetary. The padlock is unlocked.

>wait 3 hours
It is now 12:14 pm.

>s
Graves
The graves here are dillapidated, nearly crumbling, and covered with ivy and various weeds. The villagers don't seem to be taking much care of them. 

A door of old, yellowed iron, with a heavy padlock, is barring the entrance to the cemetary. The padlock is unlocked.

A heavy stone door blocks the entrance to the mausoleum. A weird stone plaque with some odd, geometric-shaped depressions, is on the door. There are a round plate, a square plate, a triangle plate and a hexagon plate

>wait for 3 hours
It is now 3:15 pm.

>look
Graves
The graves here are dillapidated, nearly crumbling, and covered with ivy and various weeds. The villagers don't seem to be taking much care of them. 

A door of old, yellowed iron, with a heavy padlock, is barring the entrance to the cemetary. The padlock is unlocked.

A heavy stone door blocks the entrance to the mausoleum. A weird stone plaque with some odd, geometric-shaped depressions, is on the door. There are a round plate, a square plate, a triangle plate and a hexagon plate

You can also see two zombies here.

>n
Graveyard Entrance
A door of old, yellowed iron, with a heavy padlock, is barring the entrance to the cemetary. The padlock is unlocked.

>wait 21 hours
It is now 12:17 pm.

>s
Graves
The graves here are dillapidated, nearly crumbling, and covered with ivy and various weeds. The villagers don't seem to be taking much care of them. 

A door of old, yellowed iron, with a heavy padlock, is barring the entrance to the cemetary. The padlock is unlocked.

A heavy stone door blocks the entrance to the mausoleum. A weird stone plaque with some odd, geometric-shaped depressions, is on the door. There are a round plate, a square plate, a triangle plate and a hexagon plate

You can also see two zombies here.

>wait 3 hours
The zombie is in your face, preventing you from doing that.

>n
Graveyard Entrance
A door of old, yellowed iron, with a heavy padlock, is barring the entrance to the cemetary. The padlock is unlocked.

>wait 3 hours
It is now 3:20 pm.

>s
Graves
The graves here are dillapidated, nearly crumbling, and covered with ivy and various weeds. The villagers don't seem to be taking much care of them. 

A door of old, yellowed iron, with a heavy padlock, is barring the entrance to the cemetary. The padlock is unlocked.

A heavy stone door blocks the entrance to the mausoleum. A weird stone plaque with some odd, geometric-shaped depressions, is on the door. There are a round plate, a square plate, a triangle plate and a hexagon plate

You can also see two zombies here.

>n
Graveyard Entrance
A door of old, yellowed iron, with a heavy padlock, is barring the entrance to the cemetary. The padlock is unlocked.

>wait 21 hours
It is now 12:22 pm.

>s
Graves
The graves here are dillapidated, nearly crumbling, and covered with ivy and various weeds. The villagers don't seem to be taking much care of them. 

A door of old, yellowed iron, with a heavy padlock, is barring the entrance to the cemetary. The padlock is unlocked.

A heavy stone door blocks the entrance to the mausoleum. A weird stone plaque with some odd, geometric-shaped depressions, is on the door. There are a round plate, a square plate, a triangle plate and a hexagon plate

You can also see two zombies here.

* * *

The Dragon and the Phoenix
An Interactive Fiction by Martin Markov
Release 1 / Serial number 180909 / Inform 7 build 6M62 (I6/v6.33 lib 6/12N) SD

Park
You've been tugging at the end of your leash, but Mom's been holding you back the whole way.  Finally, you've reached the park. It is a beautiful day with neary a cloud roaming in the sky, and the park is full with people and other dogs.

Mom pulls out your favourite chewed out tennis ball, and throws it. "Go fetch the ball, Drake!". The tennis ball rolls next to a large tree.

Mom is waiting for you.

>teleport bird park
That's not a verb I recognise.

>teleport bird to park
That's not a verb I recognise.

* * *

The Dragon and the Phoenix
An Interactive Fiction by Martin Markov
Release 1 / Serial number 180909 / Inform 7 build 6M62 (I6/v6.33 lib 6/12N) SD

Park
You've been tugging at the end of your leash, but Mom's been holding you back the whole way.  Finally, you've reached the park. It is a beautiful day with neary a cloud roaming in the sky, and the park is full with people and other dogs.

Mom pulls out your favourite chewed out tennis ball, and throws it. "Go fetch the ball, Drake!". The tennis ball rolls next to a large tree.

Mom is waiting for you.

>teleport bird to park
You can't see any such thing.

>teleport ball to park
You can't see any such thing.

* * *

The Dragon and the Phoenix
An Interactive Fiction by Martin Markov
Release 1 / Serial number 180909 / Inform 7 build 6M62 (I6/v6.33 lib 6/12N) SD

Park
You've been tugging at the end of your leash, but Mom's been holding you back the whole way.  Finally, you've reached the park. It is a beautiful day with neary a cloud roaming in the sky, and the park is full with people and other dogs.

Mom pulls out your favourite chewed out tennis ball, and throws it. "Go fetch the ball, Drake!". The tennis ball rolls next to a large tree.

Mom is waiting for you.

>teleport bird
You can't see any such thing.

>port claw
You can't see any such thing.

>port claw park
You can't see any such thing.

* * *

>teleport bird
You can't see any such thing.

>teleport bird to park
You can't see any such thing.

>teleport ball
You can't see any such thing.

>look
Park
It is a beautiful day with neary a cloud roaming in the sky, and the park is full with people and other dogs.

Your favourite ball is sitting next to a large tree.

Mom is waiting for you.

* * *

>teleport bird
You can't see any such thing.

>teleport ball
You can't see any such thing.

>port ball
You can't see any such thing.

>get ball
"Now give me the ball, Drake!"

>put ball
(in the ball)
You can't put something inside itself.

>drop ball
Dropped.

>get ball
"Now give me the ball, Drake!"

>give ball to mom
"Good Boy!", says Mom, and gives you a treat. You gulp it immediately and wag your tail in delight

>port claw tavern
You can't see any such thing.

* * *

The Dragon and the Phoenix
An Interactive Fiction by Martin Markov
Release 1 / Serial number 180909 / Inform 7 build 6M62 (I6/v6.33 lib 6/12N) SD

Park
You've been tugging at the end of your leash, but Mom's been holding you back the whole way.  Finally, you've reached the park. It is a beautiful day with neary a cloud roaming in the sky, and the park is full with people and other dogs.

Mom pulls out your favourite chewed out tennis ball, and throws it. "Go fetch the ball, Drake!". The tennis ball rolls next to a large tree.

Mom is waiting for you.

>port bird
I only understood you as far as wanting to port.

>port bird of prey
I only understood you as far as wanting to port.

>port claw
I only understood you as far as wanting to port.

* * *

The Dragon and the Phoenix
An Interactive Fiction by Martin Markov
Release 1 / Serial number 180909 / Inform 7 build 6M62 (I6/v6.33 lib 6/12N) SD

Park
You've been tugging at the end of your leash, but Mom's been holding you back the whole way.  Finally, you've reached the park. It is a beautiful day with neary a cloud roaming in the sky, and the park is full with people and other dogs.

Mom pulls out your favourite chewed out tennis ball, and throws it. "Go fetch the ball, Drake!". The tennis ball rolls next to a large tree.

Mom is waiting for you.

>TELEPORT BIRD
You can't see any such thing.

>teleport bird
You can't see any such thing.

* * *

>teleport ball
You can't see any such thing.

>look ball
You see nothing special about the ball.

* * *

The Dragon and the Phoenix
An Interactive Fiction by Martin Markov
Release 1 / Serial number 180909 / Inform 7 build 6M62 (I6/v6.33 lib 6/12N) SD

Park
You've been tugging at the end of your leash, but Mom's been holding you back the whole way.  Finally, you've reached the park. It is a beautiful day with neary a cloud roaming in the sky, and the park is full with people and other dogs.

Mom pulls out your favourite chewed out tennis ball, and throws it. "Go fetch the ball, Drake!". The tennis ball rolls next to a large tree.

Mom is waiting for you.

>teleport ball
You can't see any such thing.

>move ball
Nothing obvious happens.

>look
Park
It is a beautiful day with neary a cloud roaming in the sky, and the park is full with people and other dogs.

Your favourite ball is sitting next to a large tree.

Mom is waiting for you.

>SHOWME
Park - room
    yourself - person
    ball
    Mom - person

>x me
Your coat is black, soft and shiny. Your paws are soft, smooth and agile. Your claws are white and neat, since Mom insists on cutting them for you.

* * *

The Dragon and the Phoenix
An Interactive Fiction by Martin Markov
Release 1 / Serial number 180909 / Inform 7 build 6M62 (I6/v6.33 lib 6/12N) SD

Park
You've been tugging at the end of your leash, but Mom's been holding you back the whole way.  Finally, you've reached the park. It is a beautiful day with neary a cloud roaming in the sky, and the park is full with people and other dogs.

Mom pulls out your favourite chewed out tennis ball, and throws it. "Go fetch the ball, Drake!". The tennis ball rolls next to a large tree.

Mom is waiting for you.

>w
You can't go that way.

* * *

>take 9 roses
rose: Taken.
rose: Taken.
rose: Taken.
rose: Taken.
rose: Taken.
rose: Taken.
rose: Taken.
rose: Taken.
rose: Taken.

>in
You can't go that way.

>iv
That's not a verb I recognise.

>inv
You are carrying:
  nine roses

>look
Garden
A number of sickly-looking vegetables grow around the garden of the tavern. A huge rosebush grows next to the wall of the tavern. A dinky door blocks a trail into the hill behind the tavern.

Through the green door's window you can see the tavern keeper still "cleaning" the same glass.

On the rosebush a single rose is drawing the eye, its flower the colour of blood.
.

* * *

>n
Thick Forest
The forest is getting so thick you can hardly walk around the trees, and when you do, you get stuck in the 

An extraordinary large mullein plant grows here. Its leaves are so large it seems they can support your weight.

>take eaf
You can't see any such thing.

>take leaf
Taken.

* * *

>d
You manage to sneak by the tavern keeper and go downstairs.

Basement
Jars, bottles, crates and boxes of all kinds are scattered around the basement.

A hunk of yellow cheese is sitting on one of the boxes.

Something is shimmering on a crate in the furthest corner. On closer inspection it seems to be an iron key with a round end.

>take key
Taken.

>take cheese
Taken.

>up
Tavern
You are in a large room with several long wooden tables with benches, and a bar. Next to it you can see a stairway leading down. A large oaken log is slowly burning in the fireplace, producing more heat than light. Shadows dance around the room, barely lighting the faces of the people here. 

Next to the far side of the bar, on the west side of the tavern, there is a green door with a circular window, apparently leading to the garden.

A door made out of brown logs held together by metal rings is on the south wall. The coat rack and the welcome mat next to it suggest it is the front door.

A surly, bald man stands behind the bar, absent-mindedly washing a glass with an extremely dirty cloth.

A tall man wearing a long, gray cloak and eyepatch is sitting, cross-legged, next to the fire. He is carrying a long staff. Many silver hairs shimmer in his otherwise dark beard. A raven is sitting on his shoulder. He seems like a person that would be worthwile to listen to.

Above the fireplace hangs a peculiar engraving of a bird that appears to be on fire. You notice that occasionally the tall man throws a look at it and appears very thoughtful.

>s
(first opening the front door)

Front Lawn
Outside the tavern, you see it is a large building painted white, with a red roof and a small brick chimney.
There is a large empty space on which several carts are parked.
A wide dirt road stretches in front of you. To the east a large statue towers in the middle of the village square with. To the west you can see a tall metal fence surrounding a number of graves overgrown with ivy, with a mausoleum made of white stone in the back of it.

A door made out of brown logs held together by metal rings is on the wall of the Tavern.

>w
Graveyard Entrance
A door of old, yellowed iron, with a heavy padlock, is barring the entrance to the cemetary. The padlock is locked.

>unlock door
What do you want to unlock the metal door with?

>unlock door with key
You unlock the metal door.

>s
(first opening the metal door)

Graves
The graves here are dillapidated, nearly crumbling, and covered with ivy and various weeds. The villagers don't seem to be taking much care of them. 

A door of old, yellowed iron, with a heavy padlock, is barring the entrance to the cemetary. The padlock is unlocked.

A heavy stone door blocks the entrance to the mausoleum. A weird stone plaque with some odd, geometric-shaped depressions, is on the door. There are a round plate, a square plate, a triangle plate and a hexagon plate

You can also see two zombies here.

* * *

>n
Graveyard Entrance
A door of old, yellowed iron, with a heavy padlock, is barring the entrance to the cemetary. The padlock is unlocked.

>wait 3 hours
It is now 12:11 pm.

>s
Graves
The graves here are dillapidated, nearly crumbling, and covered with ivy and various weeds. The villagers don't seem to be taking much care of them. 

A door of old, yellowed iron, with a heavy padlock, is barring the entrance to the cemetary. The padlock is unlocked.

A heavy stone door blocks the entrance to the mausoleum. A weird stone plaque with some odd, geometric-shaped depressions, is on the door. There are a round plate, a square plate, a triangle plate and a hexagon plate

>open door
Which do you mean, the metal door or the stone door?

>open stone door
It isn't something you can open.

>push hexagon
The plate slides backwards and falls down somewhere. The stone door opens with a deep rumble.

>l
Graves
The graves here are dillapidated, nearly crumbling, and covered with ivy and various weeds. The villagers don't seem to be taking much care of them. 

A door of old, yellowed iron, with a heavy padlock, is barring the entrance to the cemetary. The padlock is unlocked.

The stone door is open to the side.

>go in
Mausoleum
The mausoleum hasn't seen daylight in years. Cobwebs are littered in the corners, and an assortment of old, dry bones are scattered around in the dust.

The stone door is open to the side.

An ancient tomb covered by a stone plate is laying in the middle of the room.

>open tomb
You open the tomb, revealing a claw.

>take claw
The claw attaches itself to one of your claws. Suddenly, it, and all your other claws, start growing, and turn from their normal white to a strange, metallic black. You feel dangerous.

>out
Graves
The graves here are dillapidated, nearly crumbling, and covered with ivy and various weeds. The villagers don't seem to be taking much care of them. 

The stone door is open to the side.

A door of old, yellowed iron, with a heavy padlock, is barring the entrance to the cemetary. The padlock is unlocked.

>wait 3 hours
It is now 3:19 pm.

>look
Graves
The graves here are dillapidated, nearly crumbling, and covered with ivy and various weeds. The villagers don't seem to be taking much care of them. 

The stone door is open to the side.

A door of old, yellowed iron, with a heavy padlock, is barring the entrance to the cemetary. The padlock is unlocked.

You can also see two zombies here.

>n
Graveyard Entrance
A door of old, yellowed iron, with a heavy padlock, is barring the entrance to the cemetary. The padlock is unlocked.

>wait 21 hours
It is now 12:21 pm.

>s
Graves
The graves here are dillapidated, nearly crumbling, and covered with ivy and various weeds. The villagers don't seem to be taking much care of them. 

A door of old, yellowed iron, with a heavy padlock, is barring the entrance to the cemetary. The padlock is unlocked.

The stone door is open to the side.

>wait 3 hours
It is now 3:22 pm.

>look
Graves
The graves here are dillapidated, nearly crumbling, and covered with ivy and various weeds. The villagers don't seem to be taking much care of them. 

A door of old, yellowed iron, with a heavy padlock, is barring the entrance to the cemetary. The padlock is unlocked.

The stone door is open to the side.

You can also see two zombies here.

* * *

The Dragon and the Phoenix
An Interactive Fiction by Martin Markov
Release 1 / Serial number 180909 / Inform 7 build 6M62 (I6/v6.33 lib 6/12N) SD

Park
You've been tugging at the end of your leash, but Mom's been holding you back the whole way.  Finally, you've reached the park. It is a beautiful day with neary a cloud roaming in the sky, and the park is full with people and other dogs.

Mom pulls out your favourite chewed out tennis ball, and throws it. "Go fetch the ball, Drake!". The tennis ball rolls next to a large tree.

Mom is waiting for you.

>purloin carapace
[Purloined.]

>purloin carapaces
[Purloined.]

>inv
You are carrying:
  three carapaces nowhere

>purloin rose
[Purloined.]

>purloin roses
[Purloined.]

>inc
That's not a verb I recognise.

>inv
You are carrying:
  a rose
  three carapaces nowhere

>z
You played in the park for hours, dashing around the people and chasing the other dogs. When Mom finally brought you home, you were so tired you were not even able to have your dinner. You just fell in your bed in the flat's corridor, and doze off.

Tavern
In your sleep, you try rolling around in your bed. It feels surprusingly hard, and you wake up startled, next to a lit fireplace. You are in a large room with several long wooden tables with benches, and a bar. A large oaken log is slowly burning in the fireplace, producing more heat than light. Shadows dance around the room, barely lighting the faces of the people here. 

Next to the far side of the bar, on the west side of the tavern, there is a green door with a circular window, apparently leading to the garden.

A door made out of brown logs held together by metal rings is on the south wall. The coat rack and the welcome mat next to it suggest it is the front door.

A surly, bald man stands behind the bar, absent-mindedly washing a glass with an extremely dirty cloth.

A tall man wearing a long, gray cloak and eyepatch is sitting, cross-legged, next to the fire. He is carrying a long staff. Many silver hairs shimmer in his otherwise dark beard. A raven is sitting on his shoulder.

Above the fireplace hangs a peculiar engraving of a bird that appears to be on fire. You notice that occasionally the tall man throws a look at it and appears very thoughtful.

>w
(first opening the green door)

Garden
A number of sickly-looking vegetables grow around the garden of the tavern. A huge rosebush grows next to the wall of the tavern. A dinky door blocks a trail into the hill behind the tavern.

Through the green door's window you can see the tavern keeper still "cleaning" the same glass.

On the rosebush several roses are scattered like blotches of blood red paint.

* * *

>take rose
Taken.

>inv
You are carrying:
  three roses
  three carapaces nowhere

* * *

>purloin carapace
[Purloined.]

>inv
You are carrying:
  a carapace

>purloin carapace
[Purloined.]

>purloin carapace
[Purloined.]

* * *

The Dragon and the Phoenix
An Interactive Fiction by Martin Markov
Release 1 / Serial number 180909 / Inform 7 build 6M62 (I6/v6.33 lib 6/12N) SD

Park
You've been tugging at the end of your leash, but Mom's been holding you back the whole way.  Finally, you've reached the park. It is a beautiful day with neary a cloud roaming in the sky, and the park is full with people and other dogs.

Mom pulls out your favourite chewed out tennis ball, and throws it. "Go fetch the ball, Drake!". The tennis ball rolls next to a large tree.

Mom is waiting for you.

>take carapace
Taken.

>look
garden
A number of sickly-looking vegetables grow around the garden of the tavern. A huge rosebush grows next to the wall of the tavern. A dinky door blocks a trail into the hill behind the tavern.

Through the green door's window you can see the tavern keeper still "cleaning" the same glass.

On the rosebush several roses are scattered like blotches of blood red paint.

You can also see two carapaces here.

>x carapace
You see nothing special about the carapace.

* * *

The Dragon and the Phoenix
An Interactive Fiction by Martin Markov
Release 1 / Serial number 180909 / Inform 7 build 6M62 (I6/v6.33 lib 6/12N) SD

Park
You've been tugging at the end of your leash, but Mom's been holding you back the whole way.  Finally, you've reached the park. It is a beautiful day with neary a cloud roaming in the sky, and the park is full with people and other dogs.

Mom pulls out your favourite chewed out tennis ball, and throws it. "Go fetch the ball, Drake!". The tennis ball rolls next to a large tree.

Mom is waiting for you.

>showme table
There seems to be no such object anywhere in the model world.

>showme table of hints
There seems to be no such object anywhere in the model world.

>showme Table of Hints
There seems to be no such object anywhere in the model world.

>showme the contents of Table of Hints
There seems to be no such object anywhere in the model world.

>showme the contents of (Table of Hints)
There seems to be no such object anywhere in the model world.

>showme the contents of table Table of Hints
There seems to be no such object anywhere in the model world.

>showme the contents of table hints
There seems to be no such object anywhere in the model world.

* * *

The Dragon and the Phoenix
An Interactive Fiction by Martin Markov
Release 1 / Serial number 180909 / Inform 7 build 6M62 (I6/v6.33 lib 6/12N) SD

Park
You've been tugging at the end of your leash, but Mom's been holding you back the whole way.  Finally, you've reached the park. It is a beautiful day with neary a cloud roaming in the sky, and the park is full with people and other dogs.

Mom pulls out your favourite chewed out tennis ball, and throws it. "Go fetch the ball, Drake!". The tennis ball rolls next to a large tree.

Mom is waiting for you.

>showme the contents of (table of hints)
There seems to be no such object anywhere in the model world.

>showme the contents of hints
There seems to be no such object anywhere in the model world.

>z
You played in the park for hours, dashing around the people and chasing the other dogs. When Mom finally brought you home, you were so tired you were not even able to have your dinner. You just fell in your bed in the flat's corridor, and doze off.

Tavern
In your sleep, you try rolling around in your bed. It feels surprusingly hard, and you wake up startled, next to a lit fireplace. You are in a large room with several long wooden tables with benches, and a bar. A large oaken log is slowly burning in the fireplace, producing more heat than light. Shadows dance around the room, barely lighting the faces of the people here. 

Next to the far side of the bar, on the west side of the tavern, there is a green door with a circular window, apparently leading to the garden.

A door made out of brown logs held together by metal rings is on the south wall. The coat rack and the welcome mat next to it suggest it is the front door.

A surly, bald man stands behind the bar, absent-mindedly washing a glass with an extremely dirty cloth.

A tall man wearing a long, gray cloak and eyepatch is sitting, cross-legged, next to the fire. He is carrying a long staff. Many silver hairs shimmer in his otherwise dark beard. A raven is sitting on his shoulder. He seems like a person that would be worthwile to listen to.

Above the fireplace hangs a peculiar engraving of a bird that appears to be on fire. You notice that occasionally the tall man throws a look at it and appears very thoughtful.

>listen to stranger
The stranger looks at you, then turns his gaze to the engraving.

"They say the phoenix is reborn again, after it dies, pup.", he starts. "And that is true.".

"And yet, here it is, turned into a lifeless representation of what it once was."

"Everything is made of base parts, and the phoenix is no exception."

"Some time ago, its essence got taken from it. I don't know how, or who did it - I only found out when it was too late."

"I do know, however, that the phoenix's parts - its heart, wing, ash, and claw, are here."

"Find them. Come back here. Touch the engraving. I'll make sure to return you to your home, with the reward you deserve."

>g
The wing is in the mountains.

>g
The ash is under the village monument.

>g
Helping others is a reward in itself, but may provide you with actual rewards, if you are persistent enough.

>g
The ash is under the village monument.

>g
To cross the lake, find something to carry your weight.

>g
After getting everything, touch the engraving of the phoenix.

>g
The wing is in the mountains.

>g
To cross the lake, find something to carry your weight.

>purloin heart
[Purloined.]

* * *

>take heart
The heart rises in the air, starts glowing, and turns into a ray of light that shoots straight at your heart. You feel a warm light spreading inside you. Your mind expands to new understanding and you feel you can now talk to people.

>listen to stranger
The wing is in the mountains.

>listen to stranger
The wing is in the mountains.

>listen to stranger
After getting everything, touch the engraving of the phoenix.

>listen to stranger
The claw is in the graveyard.

>listen to stranger
After getting everything, touch the engraving of the phoenix.

>listen to stranger
The ash is under the village monument.

>listen to stranger
The claw is in the graveyard.

>listen to stranger
The ash is under the village monument.

>listen to stranger
The ash is under the village monument.

>listen to stranger
The wing is in the mountains.

>showme the contents of the table of hints
There seems to be no such object anywhere in the model world.

* * *

The Dragon and the Phoenix
An Interactive Fiction by Martin Markov
Release 1 / Serial number 180909 / Inform 7 build 6M62 (I6/v6.33 lib 6/12N) SD

Park
You've been tugging at the end of your leash, but Mom's been holding you back the whole way.  Finally, you've reached the park. It is a beautiful day with neary a cloud roaming in the sky, and the park is full with people and other dogs.

Mom pulls out your favourite chewed out tennis ball, and throws it. "Go fetch the ball, Drake!". The tennis ball rolls next to a large tree.

Mom is waiting for you.

>wait 6 hours
It is now 3:00 pm.

>wait
You played in the park for hours, dashing around the people and chasing the other dogs. When Mom finally brought you home, you were so tired you were not even able to have your dinner. You just fell in your bed in the flat's corridor, and doze off.

Tavern
In your sleep, you try rolling around in your bed. It feels surprusingly hard, and you wake up startled, next to a lit fireplace. You are in a large room with several long wooden tables with benches, and a bar. Next to it you can see a stairway leading down. A large oaken log is slowly burning in the fireplace, producing more heat than light. Shadows dance around the room, barely lighting the faces of the people here. 

Next to the far side of the bar, on the west side of the tavern, there is a green door with a circular window, apparently leading to the garden.

A door made out of brown logs held together by metal rings is on the south wall. The coat rack and the welcome mat next to it suggest it is the front door.

A surly, bald man stands behind the bar, absent-mindedly washing a glass with an extremely dirty cloth.

A tall man wearing a long, gray cloak and eyepatch is sitting, cross-legged, next to the fire. He is carrying a long staff. Many silver hairs shimmer in his otherwise dark beard. A raven is sitting on his shoulder. He seems like a person that would be worthwile to listen to.

Above the fireplace hangs a peculiar engraving of a bird that appears to be on fire. You notice that occasionally the tall man throws a look at it and appears very thoughtful.